म		M AH 
यो		Y OH  
छ		CHA AH 
कृपया		K AH R P AH Y AA  
मलाई		M AH L AA  IH 
कि		K IH  
के		K EH  
मेरो		M EH  R OH  
छ।		CHA AH 
चाहन्छु।		CH AA  HH AH N AH  CHA UH  
लागि		L AA  G IH  
हो		HH OH  
कति		K AH TH IH  
तपाईं		TH AH P AA  IH M
कहाँ		K AH HH AA N 
दिनुहोस्।		DH IH  N UH  HH OH  S AH  
एउटा		EW T AA  
गर्न		G AH R AH  N AH 
होला		HH OH  L AA  
हो।		HH OH  
मैले		M AH IH  L EH  
यहाँ		Y AH HH AA N 
त्यो		TH AH  Y OH  
तपाईंको		TH AH P AA  IH MK OH  
केही		K EH  HH IH  
र		R AH 
एक		EH K AH 
छैन।		CHA AH IH  N AH 
माफ		M AA  PA AH 
सक्छु		S AH K AH  CHA UH  
हुन्छ		HH UH  N AH  CHA AH 
की		K IH  
धेरै		DHA EH  R AH IH  
कुन		K UH  N AH 
तपाईंलाई		TH AH P AA  IH ML AH AA IH 
राम्रो		R AA  M AH  R OH  
कुनै		K UH  N AH IH  
सँग		S AHN G AH 
कस्तो		K AH S AH  TH OH  
सक्नुहुन्थ्यो		S AH K AH  N UH  HH AH UH N AH  THA AH  Y OH  
समय		S AH M AH Y AH 
हामी		HH AA  M IH  
धन्यवाद।		DHA AH N AH  Y AH W AA  DH AH 
दुई		DH UH  IH 
सक्नुहुन्छ		S AH K AH  N UH  HH AH UH N AH  CHA AH 
पनि		P AH N IH  
भएको		BA EH  K OH  
पर्छ		P AH R AH  CHA AH 
कोठा		K OH  TA AA  
अर्को		AH R AH  K OH  
सकिन्छ		S AH K IH  N AH  CHA AH 
लाग्छ		L AA  G AH  CHA AH 
हजुर		HH AH JH UH  R AH 
छन्		CHA AH N AH  
फोन		PA OH  N AH 
खाना		KA AA  N AH AA 
को		K OH  
सिट		S IH  T AH 
जान		JH AA  N AH 
अहिले		AH HH IH  L EH  
लिन		L IH  N AH 
कहिले		K AH HH IH  L EH  
छु।		CHA UH  
जाने		JH AA  N EH  
नम्बर		N AH M AH  B AH R AH 
दिन		DH IH  N AH 
टिकट		T IH  K AH T AH 
तपाईंले		TH AH P AA  IH ML EH  
कसरी		K AH S AH R IH  
भयो।		BA AH Y OH  
बजे		B AH JH EH  
हजुर।		HH AH JH UH  R AH 
बस		B AH S AH 
हुन्छ।		HH UH  N AH  CHA AH 
जापानी		JH AA  P AH AA N IH  
सम्म		S AH M AH  M AH 
हेर्न		HH EH  R AH  N AH 
आज		AA JH AH 
नाम		N AA  M AH 
सबै		S AH B AH IH  
पाउन		P AA  UH N AH 
गर्नुहोस्।		G AH R AH  N UH  HH OH  S AH  
तीन		TH IH  N AH 
गर्नुहोला।		G AH R AH  N UH  HH OH  L AA  
चेक		CH EH  K AH 
डलर		D AH L AH R AH 
गर्ने		G AH R AH  N EH  
कुरा		K UH  R AA  
त्यहाँ		TH AH  Y AH HH AA N 
सामान		S AA  M AH AA N AH 
अलि		AH L IH  
मिल्छ		M IH  L AH  CHA AH 
चाहनुहुन्छ		CH AA  HH AH N UH  HH AH UH N AH  CHA AH 
ठाउँ		TA AA  UHN 
प्रयोग		P AH  R AH Y OH  G AH 
यसलाई		Y AH S AH L AA  IH 
गर्छु।		G AH R AH  CHA UH  
तर		TH AH R AH 
पैसा		P AH IH  S AA  
जस्तो		JH AH S AH  TH OH  
शुल्क		S UH  L AH  K AH 
गर्नुहुन्छ		G AH R AH  N UH  HH AH UH N AH  CHA AH 
लाग्यो।		L AA  G AH  Y OH  
पाँच		P AA N CH AH 
पाउनसक्छु		P AA  UH N AH S AH K AH  CHA UH  
अनि		AH N IH  
गरेको		G AH R EH  K OH  
ठिक		TA IH  K AH 
ए		EH 
यसको		Y AH S AH K OH  
गर्नुहोला		G AH R AH  N UH  HH OH  L AA  
हुनुहुन्छ		HH UH  N AH UH HH AH UH N AH  CHA AH 
भन्न		BA AH N AH  N AH 
ठीक		TA IH  K AH 
होइन		HH OH  IH N AH 
पानी		P AA  N IH  
थाहा		THA AA  HH AH AA 
सय		S AH Y AH 
कार्ड		K AA  R AH  D AH 
केहि		K EH  HH IH  
भने		BA AH N EH  
झोला		JHA OH  L AA  
छन्।		CHA AH N AH  
मसँग		M AH S AHN G AH 
तपाईंसँग		TH AH P AA  IH MS AHN G AH 
किन्न		K IH  N AH  N AH 
होइन।		HH OH  IH N AH 
थियो।		THA IH  Y OH  
गाडी		G AA  D IH  
गर्नसक्छु		G AH R AH  N AH S AH K AH  CHA UH  
त		TH AH 
भयो		BA AH Y OH  
भन्दा		BA AH N AH  DH AA  
संग		S AH MG AH 
मन		M AH N AH 
न।		N AH 
तपाई		TH AH P AA  IH 
सात		S AA  TH AH 
फिर्ता		PA IH  R AH  TH AA  
अझै		AH JHA AH IH  
पाइन्छ		P AA  IH N AH  CHA AH 
जापानमा		JH AA  P AH AA N AH M AH AA 
दिनुहोला।		DH IH  N UH  HH OH  L AA  
आफ्नो		AA PA AH  N OH  
सबैभन्दा		S AH B AH IH  BA AH N AH  DH AA  
होला।		HH OH  L AA  
लागी		L AA  G IH  
धुम्रपान		DHA UH  M AH  R AH P AA  N AH 
ट्याक्सी		T AH  Y AA  K AH  S IH  
चार		CH AA  R AH 
कफी		K AH PA IH  
बाट		B AA  T AH 
भित्र		BA IH  TH AH  R AH 
छैन		CHA AH IH  N AH 
गर्नुहोस्		G AH R AH  N UH  HH OH  S AH  
रिजर्भेसन		R IH  JH AH R AH  BA EH  S AH N AH 
पसल		P AH S AH L AH 
पठाउन		P AH TA AA  UH N AH 
अरु		AH R UH  
भोलि		BA OH  L IH  
मा		M AA  
सानो		S AA  N OH  
जापान		JH AA  P AH AA N AH 
कतिबजे		K AH TH IH  B AH JH EH  
ट्रेन		T AH  R EH  N AH 
काम		K AA  M AH 
फोटो		PA OH  T AH OH 
देखाउनुहोस्।		DH EH  KA AA  UH N UH  HH OH  S AH  
फेरी		PA EH  R IH  
हाम्रो		HH AA  M AH  R OH  
नै		N AH IH  
मद्दत		M AH DH AH  DH AH TH AH 
खान		KA AA  N AH 
कार		K AA  R AH 
दिनुहुन्छ		DH IH  N UH  HH AH UH N AH  CHA AH 
फेरि		PA EH  R IH  
कल		K AH L AH 
भाडामा		BA AA  D AH AA M AH AA 
एकदम		EH K AH DH AH M AH 
आठ		AA TA AH 
दश		DH AH S AH 
पछि		P AH CHA IH  
फ्लाईट		PA AH  L AA  IH T AH 
बाटो		B AA  T OH  
हुने		HH UH  N EH  
बताईदिनुहुन्छ		B AH TH AA  IH DH IH  N UH  HH AH UH N AH  CHA AH 
मात्र		M AA  TH AH  R AH 
थियो		THA IH  Y OH  
रसिद		R AH S IH  DH AH 
औषधि		AH UN S AH DHA IH  
क्रेडिट		K AH  R EH  D IH  T AH 
वटा		W AH T AA  
पक्का		P AH K AH  K AA  
पर्छ।		P AH R AH  CHA AH 
थिएँ।		THA IH  EHN 
ठुलो		TA UH  L OH  
गरिदिनुहोस्।		G AH R IH  DH AH IH N UH  HH OH  S AH  
बाहिर		B AA  HH IH  R AH 
नजिकै		N AH JH IH  K AH AH IH 
बस्न		B AH S AH  N AH 
लाग्छ।		L AA  G AH  CHA AH 
कोठामा		K OH  TA AA  M AH AA 
यसमा		Y AH S AH M AA  
हुँ।		HH UH N 
लिएर		L IH  EH R AH 
गरेर		G AH R EH  R AH 
अर्डर		AH R AH  D AH R AH 
साट्न		S AA  T AH  N AH 
जति		JH AH TH IH  
भए		BA EH  
छिटो		CHA IH  T OH  
साँचो		S AA N CH OH  
सस्तो		S AH S AH  TH OH  
खालको		KA AA  L AH K OH  
नमस्ते।		N AH M AH S AH  TH EH  
आएको		AA EH K OH  
स्टेशन		S AH  T EH  S AH N AH 
मिनेट		M IH  N EH  T AH 
सकिन्थ्यो		S AH K IH  N AH  THA AH  Y OH  
बिहान		B IH  HH AA  N AH 
कर		K AH R AH 
लामो		L AA  M OH  
लागि।		L AA  G IH  
दिनको		DH IH  N AH K OH  
दुख्छ।		DH UH  KA AH  CHA AH 
खाली		KA AA  L IH  
भ्रमण		BA AH  R AH M AH N AH 
जे		JH EH  
शौचालय		S AH UH  CH AA  L AH Y AH 
नौ		N AH UH  
गर्नु		G AH R AH  N UH  
बारेमा		B AA  R EH  M AH AA 
जना		JH AH N AA  
अझ		AH JHA AH 
रेस्टुरेन्ट		R EH  S AH  T UH  R AH EH N AH  T AH 
कोठाको		K OH  TA AA  K AH OH 
तिर्न		TH IH  R AH  N AH 
रिजर्भ		R IH  JH AH R AH  BA AH 
लागेको		L AA  G EH  K OH  
भाषा		BA AA  S AH AA 
हुनुहुन्छ।		HH UH  N AH UH HH AH UH N AH  CHA AH 
बन्द		B AH N AH  DH AH 
गरिदिनुहुन्छ		G AH R IH  DH AH IH N UH  HH AH UH N AH  CHA AH 
टाढा		T AA  DA AH AA 
चाहिं		CH AA  HH IH  M
दुखेको		DH UH  KA EH  K OH  
हामीले		HH AA  M IH  L EH  
रहेछ।		R AH HH EH  CHA AH 
महसूस		M AH HH AH S UH  S AH 
पुग्न		P UH  G AH  N AH 
दिनुहोस।		DH IH  N UH  HH OH  S AH 
आजको		AA JH AH K OH  
बेला		B EH  L AA  
टेबल		T EH  B AH L AH 
होटल		HH OH  T AH L AH 
होटेल		HH OH  T EH  L AH 
देखि		DH EH  KA IH  
शून्य		S UH  N AH  Y AH 
दुईवटा		DH UH  IH W AH T AA  
विचारमा		W IH  CH AA  R AH M AH AA 
लिन्छु।		L IH  N AH  CHA UH  
यस		Y AH S AH 
सक्नुहुन्छ।		S AH K AH  N UH  HH AH UH N AH  CHA AH 
लुगा		L UH  G AA  
तयार		TH AH Y AA  R AH 
बुक		B UH  K AH 
लिनुहोस्।		L IH  N UH  HH OH  S AH  
यहाँबाट		Y AH HH AA N B AH AA T AH 
तिमीलाई		TH IH  M AH IH L AA  IH 
भेट्न		BA EH  T AH  N AH 
यहाँको		Y AH HH AA N K OH  
अब		AH B AH 
जान्छ		JH AA  N AH  CHA AH 
पत्र		P AH TH AH  R AH 
जनाको		JH AH N AA  K OH  
चाहिन्छ		CH AA  HH IH  N AH  CHA AH 
हेर्नसक्छु		HH EH  R AH  N AH S AH K AH  CHA UH  
चाहिँ		CH AA  HH IH N 
वाइन		W AA  IH N AH 
मलाइ		M AH L AA  IH 
पटक		P AH T AH K AH 
समयमा		S AH M AH Y AH M AA  
नराम्रो		N AH R AA  M AH  R OH  
पचास		P AH CH AA  S AH 
शुभ		S UH  BA AH 
पेट		P EH  T AH 
नक्शा		N AH K AH  S AA  
छुट		CHA UH  T AH 
टाउको		T AA  UH K OH  
गलत		G AH L AH TH AH 
बियर		B IH  Y AH R AH 
प्रकारको		P AH  R AH K AA  R AH K OH  
नयाँ		N AH Y AA N 
नजिकको		N AH JH IH  K AH K OH  
त्यति		TH AH  Y AH TH IH  
छु		CHA UH  
हरायो।		HH AH R AA  Y OH  
पहिलो		P AH HH IH  L OH  
जानकारी		JH AA  N AH K AH AA R IH  
सेवा		S EH  W AA  
बिहानको		B IH  HH AA  N AH K OH  
उडान		UH D AA  N AH 
यात्रा		Y AA  TH AH  R AH AA 
समस्या		S AH M AH S AH  Y AA  
भाडा		BA AA  D AH AA 
मनपर्छ		M AH N AH P AH R AH  CHA AH 
तपाईंसंग		TH AH P AA  IH MS AH MG AH 
डाक्टर		D AA  K AH  T AH R AH 
घर		GA AH R AH 
ठूलो		TA UH  L OH  
बीस		B IH  S AH 
कतै		K AH TH AH IH  
हुलाक		HH UH  L AA  K AH 
दिनुहोस्		DH IH  N UH  HH OH  S AH  
आउनुहोस्।		AA UH N UH  HH OH  S AH  
बनेको		B AH N EH  K OH  
लिनसक्छु		L IH  N AH S AH K AH  CHA UH  
रेल		R EH  L AH 
रिजर्भेशन		R IH  JH AH R AH  BA EH  S AH N AH 
चिया		CH IH  Y AA  
सक्छौं		S AH K AH  CHA AH UH  M
धन्यबाद।		DHA AH N AH  Y AH B AA  DH AH 
चिसो		CH IH  S OH  
औषधी		AH UN S AH DHA IH  
ऊ		UH 
भन्ने		BA AH N AH  N EH  
पर्ने		P AH R AH  N EH  
तातो		TH AA  TH OH  
कता		K AH TH AA  
उपहार		UH P AH HH AA  R AH 
कार्यालय		K AA  R AH  Y AH AA L AH Y AH 
सिटमा		S IH  T AH M AA  
गर्नुपर्छ		G AH R AH  N UH  P AH R AH  CHA AH 
किन		K IH  N AH 
हामीसँग		HH AA  M IH  S AHN G AH 
जापानको		JH AA  P AH AA N AH K OH  
गर्दा		G AH R AH  DH AA  
तपाइ		TH AH P AA  IH 
खुद्रा		KA UH  DH AH  R AA  
आउन		AA UH N AH 
पासपोर्ट		P AA  S AH P OH  R AH  T AH 
लगाएर		L AH G AA  EH R AH 
गरि		G AH R IH  
होटेलमा		HH OH  T EH  L AH M AA  
देखाउन		DH EH  KA AA  UH N AH 
वा		W AA  
परिवर्तन		P AH R IH  W AH R AH  TH AH N AH 
ट्राभल		T AH  R AA  BA AH L AH 
चाहनुहुन्छ।		CH AA  HH AH N UH  HH AH UH N AH  CHA AH 
खोज्दैछु।		KA OH  JH AH  DH AH IH  CHA UH  
अलिकति		AH L IH  K AH TH AH IH 
यी		Y IH  
नजिक		N AH JH IH  K AH 
ल्याईदिन		L AH  Y AA  IH DH IH  N AH 
रहेको		R AH HH EH  K OH  
रमाइलो		R AH M AA  IH L OH  
तिर		TH IH  R AH 
डलरको		D AH L AH R AH K OH  
गराउन		G AH R AA  UH N AH 
तरिका		TH AH R IH  K AA  
खेल्न		KA EH  L AH  N AH 
यदि		Y AH DH IH  
बोल्ने		B OH  L AH  N EH  
बिल		B IH  L AH 
घोषणा		GA OH  S AH N AA  
अगाडी		AH G AA  D IH  
मासु		M AA  S UH  
चाहिन्छ।		CH AA  HH IH  N AH  CHA AH 
भनेर		BA AH N EH  R AH 
खाने		KA AA  N EH  
कपाल		K AH P AA  L AH 
कतिवटा		K AH TH IH  W AH T AA  
हवाई		HH AH W AA  IH 
सर।		S AH R AH 
समावेश		S AH M AA  W EH  S AH 
मान्छे		M AA  N AH  CHA EH  
सुरक्षित		S UH  R AH K AH  S IH  TH AH 
खानाको		KA AA  N AH AA K OH  
सल्लाह		S AH L AH  L AA  HH AH 
सफा		S AH PA AA  
राति		R AA  TH IH  
राख्न		R AA  KA AH  N AH 
माछा		M AA  CHA AH AA 
यसले		Y AH S AH L EH  
फिल्म		PA IH  L AH  M AH 
ढिलो		DA IH  L OH  
आभारी		AA BA AA  R IH  
हुन्थ्यो		HH UH  N AH  THA AH  Y OH  
सकिन।		S AH K IH  N AH 
बेला।		B EH  L AA  
मनपर्छ।		M AH N AH P AH R AH  CHA AH 
ठेगाना		TA EH  G AA  N AH AA 
शुरु		S UH  R AH UH 
भेटेर		BA EH  T AH EH R AH 
नि।		N IH  
चढ्न		CH AH DA AH  N AH 
तपाईको		TH AH P AA  IH K OH  
स्टप		S AH  T AH P AH 
सामानहरु		S AA  M AH AA N AH HH AH R UH  
जानको		JH AA  N AH K OH  
चलाउन		CH AH L AA  UH N AH 
हुन		HH UH  N AH 
सहयोग		S AH HH AH Y OH  G AH 
सक्दिनँ।		S AH K AH  DH IH  N AHN 
नमस्कार		N AH M AH S AH  K AA  R AH 
जानुहोस्।		JH AA  N UH  HH OH  S AH  
अथवा		AH THA AH W AA  
सम्पर्क		S AH M AH  P AH R AH  K AH 
पार्क		P AA  R AH  K AH 
टोकियो		T OH  K IH  Y AH OH 
कतिपर्छ		K AH TH IH  P AH R AH  CHA AH 
सुझाव		S UH  JHA AA  W AH 
पिउन		P AH IW N AH 
पक्कै		P AH K AH  K AH IH  
धन्यवाद		DHA AH N AH  Y AH W AA  DH AH 
मुख्य		M UH  KA AH  Y AH 
हामीलाई		HH AA  M IH  L AH AA IH 
बिमा		B IH  M AA  
त्यस्तो		TH AH  Y AH S AH  TH OH  
त्यसको		TH AH  Y AH S AH K OH  
तिन		TH IH  N AH 
जान्छु।		JH AA  N AH  CHA UH  
दस		DH AH S AH 
तीस		TH IH  S AH 
चीज		CH IH  JH AH 
गर्नको		G AH R AH  N AH K OH  
विशेष		W IH  S EH  S AH 
स्टेक		S AH  T EH  K AH 
भनेको		BA AH N EH  K OH  
टिकेट		T IH  K EH  T AH 
सुरु		S UH  R AH UH 
पन्ध्र		P AH N AH  DHA AH  R AH 
माथि		M AA  THA IH  
बुकिङ		B UH  K IH  NG AH 
आउट		AA UH T AH 
श्रीमान्		S AH  R IH  M AA  N AH  
उहाँ		UH HH AA N 
मेनु		M EH  N UH  
एकदमै		EH K AH DH AH M AH IH  
फारम		PA AA  R AH M AH 
प्रहरी		P AH  R AH HH AH R IH  
भन्नुहोस्।		BA AH N AH  N UH  HH OH  S AH  
रोक्नुहोस्।		R OH  K AH  N UH  HH AH OH S AH  
रद्द		R AH DH AH  DH AH 
कोही		K OH  HH IH  
है।		HH AH IH  
सक्छू		S AH K AH  CHA UH  
रातिको		R AA  TH IH  K OH  
सेन्ट		S EH  N AH  T AH 
जस्तै		JH AH S AH  TH AH IH  
स्थानीय		S AH  THA AA  N IH  Y AH 
सीट		S IH  T AH 
म्याडम		M AH  Y AA  D AH M AH 
जाँच		JH AA N CH AH 
मिठो		M IH  TA OH  
ब्याग		B AH  Y AA  G AH 
तपाईलाई		TH AH P AA  IH L AH AA IH 
हराएँ।		HH AH R AA  EHN 
झ्याल		JHA AH  Y AA  L AH 
उसलाई		UH S AH L AA  IH 
अहँ		AH HH AHN 
निकै		N IH  K AH AH IH 
थोरै		THA OH  R AH IH  
डलरमा		D AH L AH R AH M AA  
उपलब्ध		UH P AH L AH B AH  DHA AH 
माफी		M AA  PA IH  
छुट्छ		CHA UH  T AH  CHA AH 
हजुरलाई		HH AH JH UH  R AH L AA  IH 
महँगो		M AH HH AHN G OH  
कम		K AH M AH 
इन		IH N AH 
अगाडि		AH G AA  D IH  
तल		TH AH L AH 
घण्टा		GA AH N AH  T AA  
यता		Y AH TH AA  
मिल्ने		M IH  L AH  N EH  
नमस्ते		N AH M AH S AH  TH EH  
करिब		K AH R IH  B AH 
आधा		AA DHA AA  
शहरको		S AH HH AH R AH K OH  
गेट		G EH  T AH 
सन्चो		S AH N AH  CH OH  
देखाइदिनु		DH EH  KA AA  IH DH IH  N UH  
गर्दै		G AH R AH  DH AH IH  
किसीमको		K IH  S AH IH M AH K OH  
साँच्चै		S AA N CH AH  CH AH IH  
लाग्दैन।		L AA  G AH  DH AH IH  N AH 
रातो		R AA  TH OH  
नमस्कार।		N AH M AH S AH  K AA  R AH 
खुल्छ		KA UH  L AH  CHA AH 
साथी		S AA  THA IH  
मौसम		M AH UH  S AH M AH 
भएन।		BA EH  N AH 
फरक		PA AH R AH K AH 
पहिले		P AH HH IH  L EH  
निषेधित		N IH  S EH  DHA AH IH TH AH 
बजेको		B AH JH EH  K OH  
होटलमा		HH OH  T AH L AH M AA  
छोटो		CHA OH  T AH OH 
दाँत		DH AA N TH AH 
काउन्टर		K AA  UH N AH  T AH R AH 
ढोका		DA OH  K AA  
कहाँबाट		K AH HH AA N B AH AA T AH 
हुन्।		HH UH  N AH  
मूल्य		M UH  L AH  Y AH 
त्यसैले		TH AH  Y AH S AH IH  L EH  
जुत्ता		JH UH  TH AH  TH AA  
जी		JH IH  
चिज		CH IH  JH AH 
आउँछ		AA UHN CHA AH 
साइज		S AA  IH JH AH 
विचार		W IH  CH AA  R AH 
वरिपरी		W AH R IH  P AH R AH IH 
लाई		L AA  IH 
झोलाहरु		JHA OH  L AA  HH AH R UH  
पनि।		P AH N IH  
नंबर		N AH MB AH R AH 
दिने		DH IH  N EH  
चोरी		CH OH  R IH  
खेल		KA EH  L AH 
अंग्रेजी		AH MG AH  R EH  JH IH  
बिग्रियो।		B IH  G AH  R AH IH Y OH  
पर्यटक		P AH R AH  Y AH T AH K AH 
छोड्न		CHA OH  D AH  N AH 
राख्नुहोस्।		R AA  KA AH  N UH  HH OH  S AH  
सुन्दर		S UH  N AH  DH AH R AH 
येन		Y EH  N AH 
भोली		BA OH  L IH  
न्यू		N AH  Y UH  
उनी		UH N IH  
ठीकै		TA IH  K AH AH IH 
ठिकै		TA IH  K AH AH IH 
आउने		AA UH N EH  
रातको		R AA  TH AH K OH  
पहिला		P AH HH IH  L AA  
पर्खनुहोस्।		P AH R AH  KA AH N UH  HH OH  S AH  
दिन्छु।		DH IH  N AH  CHA UH  
डलर।		D AH L AH R AH 
गरें।		G AH R EH  M
कोहि		K OH  HH IH  
नि		N IH  
त्यसोभए		TH AH  Y AH S OH  BA EH  
खिच्न		KA IH  CH AH  N AH 
आउँछु।		AA UHN CHA UH  
हवस्		HH AH W AH S AH  
राम्रो।		R AA  M AH  R OH  
गिलास		G IH  L AA  S AH 
अति		AH TH IH  
लिन्छ		L IH  N AH  CHA AH 
घडी		GA AH D IH  
यस्तो		Y AH S AH  TH OH  
हजार		HH AH JH AA  R AH 
सुटकेस		S UH  T AH K EH  S AH 
खुशी		KA UH  S IH  
हुनेछ।		HH UH  N EH  CHA AH 
दिनुहुन्थ्यो		DH IH  N UH  HH AH UH N AH  THA AH  Y OH  
तुरुन्तै		TH UH  R AH UH N AH  TH AH IH  
उ		UH 
दुर्घटना		DH UH  R AH  GA AH T AH N AA  
चलचित्र		CH AH L AH CH IH  TH AH  R AH 
किसिमको		K IH  S AH IH M AH K OH  
कार्यक्रम		K AA  R AH  Y AH K AH  R AH M AH 
हात		HH AA  TH AH 
बोतल		B OH  TH AH L AH 
पैसाको		P AH IH  S AA  K OH  
लिइएको		L IH  IH EH K OH  
रात		R AA  TH AH 
प्रस्थान		P AH  R AH S AH  THA AA  N AH 
ज्वरो		JH AH  W AH R OH  
गर्दैछु।		G AH R AH  DH AH IH  CHA UH  
सिधा		S IH  DHA AA  
योजना		Y OH  JH AH N AA  
भनिदिनुहोला।		BA AH N IH  DH AH IH N UH  HH OH  L AA  
ठाउँमा		TA AA  UHN M AH AA 
नक्सा		N AH K AH  S AA  
टेलिफोन		T EH  L IH  PA OH  N AH 
राती		R AA  TH IH  
बोल्दैछु।		B OH  L AH  DH AH IH  CHA UH  
पर्ला		P AH R AH  L AA  
चोरियो।		CH OH  R IH  Y AH OH 
नाप		N AA  P AH 
गरिदिनुहोला।		G AH R IH  DH AH IH N UH  HH OH  L AA  
सर्भिस		S AH R AH  BA IH  S AH 
रुम		R UH  M AH 
बोलाइदिनुहोस्।		B OH  L AA  IH DH IH  N UH  HH AH OH S AH  
जहाज		JH AH HH AA  JH AH 
लिनुहोला।		L IH  N UH  HH OH  L AA  
सेन्ट्रल		S EH  N AH  T AH  R AH L AH 
लिनुहुन्छ		L IH  N UH  HH AH UH N AH  CHA AH 
देखिन्छ।		DH EH  KA IH  N AH  CHA AH 
टोकियोमा		T OH  K IH  Y AH OH M AA  
अन्तिम		AH N AH  TH IH  M AH 
ले		L EH  
बस्नुहुन्छ		B AH S AH  N UH  HH AH UH N AH  CHA AH 
अस्पताल		AH S AH  P AH TH AA  L AH 
रिपोर्ट		R IH  P OH  R AH  T AH 
यस्तै		Y AH S AH  TH AH IH  
क्यामेरा		K AH  Y AA  M EH  R AH AA 
बायाँ		B AA  Y AH AAN 
देखाईदिनुहुन्छ		DH EH  KA AA  IH DH IH  N UH  HH AH UH N AH  CHA AH 
टेनिस		T EH  N IH  S AH 
एकछिन		EH K AH CHA IH  N AH 
दोस्रो		DH OH  S AH  R AH OH 
तपाईँको		TH AH P AA  IHN K OH  
उनान्सय		UH N AA  N AH  S AH Y AH 
राहदानी		R AA  HH AH DH AH AA N IH  
त।		TH AH 
सही		S AH HH IH  
लिने		L IH  N EH  
बिरामी		B IH  R AA  M AH IH 
नगद		N AH G AH DH AH 
गरिएको		G AH R IH  EH K OH  
सेतो		S EH  TH OH  
सक्छु।		S AH K AH  CHA UH  
रक्सी		R AH K AH  S IH  
बाँकी		B AA N K IH  
चार्ज		CH AA  R AH  JH AH 
सलाद		S AH L AA  DH AH 
सक्ने		S AH K AH  N EH  
लगभग		L AH G AH BA AH G AH 
सन्देश		S AH N AH  DH EH  S AH 
बाटोको		B AA  T OH  K AH OH 
पिउने		P AH IW N EH  
साढे		S AA  DA EH  
भएँ।		BA EH N 
जम्मा		JH AH M AH  M AA  
साँझ		S AA N JHA AH 
मेरा		M EH  R AA  
भन्सार		BA AH N AH  S AA  R AH 
चाहियो।		CH AA  HH IH  Y OH  
एकैछिन		EH K AH IH  CHA AH IH N AH 
साइजको		S AA  IH JH AH K OH  
प्रभात।		P AH  R AH BA AA  TH AH 
प्रति		P AH  R AH TH IH  
त्यसलाई		TH AH  Y AH S AH L AA  IH 
जारी		JH AA  R IH  
घरमा		GA AH R AH M AA  
खबर		KA AH B AH R AH 
है		HH AH IH  
बसेको		B AH S EH  K OH  
चाहन्छौं।		CH AA  HH AH N AH  CHA AH UH  M
गर्नुपर्छ।		G AH R AH  N UH  P AH R AH  CHA AH 
गरिदिन		G AH R IH  DH AH IH N AH 
महसुस		M AH HH AH S UH  S AH 
बिस्तारै		B IH  S AH  TH AA  R AH AH IH 
कसैलाई		K AH S AH IH  L AA  IH 
बस्छु।		B AH S AH  CHA UH  
यहॉ		Y AH HH AH 
बढी		B AH DA IH  
ढिला		DA IH  L AA  
खुशि		KA UH  S IH  
आराम		AA R AA  M AH 
सामानको		S AA  M AH AA N AH K OH  
लोकप्रिय		L OH  K AH P AH  R IH  Y AH 
भवन		BA AH W AH N AH 
झ्यालको		JHA AH  Y AA  L AH K OH  
बैंक		B AH IH  MK AH 
जुस		JH UH  S AH 
खोल्न		KA OH  L AH  N AH 
हरेक		HH AH R EH  K AH 
सिफारिस		S IH  PA AA  R AH IH S AH 
समुन्द्री		S AH M UH  N AH  DH AH  R IH  
जानु		JH AA  N UH  
घुम्नको		GA UH  M AH  N AH K OH  
पर्यो।		P AH R AH  Y OH  
नोट		N OH  T AH 
जाडो		JH AA  D OH  
अनुसार		AH N UH  S AA  R AH 
स्टेसन		S AH  T EH  S AH N AH 
सम्म।		S AH M AH  M AH 
विमानस्थल		W IH  M AA  N AH S AH  THA AH L AH 
लिनुहोस्		L IH  N UH  HH OH  S AH  
बनाउन		B AH N AA  UH N AH 
केवल		K EH  W AH L AH 
हल्का		HH AH L AH  K AA  
सक्नु		S AH K AH  N UH  
सँगै		S AHN G AH IH  
पुग्ने		P UH  G AH  N EH  
दिउँसो		DH AH IWN S OH  
बस्ने		B AH S AH  N EH  
निश्चयनै।		N IH  S AH  CH AH Y AH N AH AH IH 
टिकटहरु		T IH  K AH T AH HH AH R UH  
जानुहोला।		JH AA  N UH  HH OH  L AH AA 
एक्सप्रेस		EH K AH  S AH P AH  R EH  S AH 
माग्छु।		M AA  G AH  CHA UH  
नम्बरको		N AH M AH  B AH R AH K OH  
सक्दिन।		S AH K AH  DH IH  N AH 
संगै		S AH MG AH IH  
दिवा		DH IH  W AA  
ट्रेनमा		T AH  R EH  N AH M AA  
हिजो		HH IH  JH OH  
बोल्न		B OH  L AH  N AH 
बिशेष		B IH  S EH  S AH 
खुसी		KA UH  S IH  
आफैले		AA PA AH IH  L EH  
भोक		BA OH  K AH 
छोडें।		CHA OH  D EH  M
मदत		M AH DH AH TH AH 
टूर		T UH  R AH 
जाँदै		JH AA N DH AH IH  
किन्ने		K IH  N AH  N EH  
किनमेल		K IH  N AH M EH  L AH 
पठाइदिनुहोस्।		P AH TA AA  IH DH IH  N UH  HH OH  S AH  
गर्नुभयो		G AH R AH  N UH  BA AH Y OH  
उहाँलाई		UH HH AA N L AH AA IH 
अभिवादन।		AH BA IH  W AA  DH AH N AH 
व्यक्ति		W AH  Y AH K AH  TH IH  
मर्मत		M AH R AH  M AH TH AH 
क्रिम		K AH  R IH  M AH 
हिंडेर		HH IH  MD EH  R AH 
राम्रोसँग		R AA  M AH  R OH  S AHN G AH 
रंग		R AH MG AH 
तल्लामा		TH AH L AH  L AA  M AH AA 
कसैले		K AH S AH IH  L EH  
होटेलको		HH OH  T EH  L AH K AH OH 
सिंगल		S IH  MG AH L AH 
समयको		S AH M AH Y AH K OH  
यात्राको		Y AA  TH AH  R AH AA K OH  
भाग		BA AA  G AH 
बाकस		B AA  K AH S AH 
चुरोट		CH UH  R OH  T AH 
आवश्यक		AA W AH S AH  Y AH K AH 
अतिरिक्त		AH TH IH  R AH IH K AH  TH AH 
चल्छ		CH AH L AH  CHA AH 
गए		G EH  
चोटि		CH OH  T IH  
खैरो		KA AH IH  R OH  
आशा		AA S AA  
अली		AH L IH  
दृश्य		DH AH R S AH  Y AH 
गएर		G EH  R AH 
हरियो		HH AH R IH  Y OH  
पसलमा		P AH S AH L AH M AA  
किताब		K IH  TH AA  B AH 
एकजना		EH K AH JH AH N AA  
स्वीकार		S AH  W IH  K AA  R AH 
शहर		S AH HH AH R AH 
भाँडा		BA AA N D AH AA 
बि		B IH  
पास		P AA  S AH 
कुर्न		K UH  R AH  N AH 
अफिस		AH PA IH  S AH 
राम्ररी		R AA  M AH  R AH R IH  
जानुहुन्छ		JH AA  N UH  HH AH UH N AH  CHA AH 
चढ्ने		CH AH DA AH  N EH  
कालो		K AA  L OH  
रंगको		R AH MG AH K OH  
फेर्न		PA EH  R AH  N AH 
परिचय		P AH R IH  CH AH Y AH 
हिल्टन		HH IH  L AH  T AH N AH 
लाइन		L AA  IH N AH 
लस		L AH S AH 
पर्स		P AH R AH  S AH 
न		N AH 
तालिका		TH AA  L IH  K AH AA 
कुनामा		K UH  N AA  M AH AA 
एलर्जी		EH L AH R AH  JH IH  
सजिलो		S AH JH IH  L OH  
सकिनँ।		S AH K IH  N AHN 
बाह्र		B AA  HH AH  R AH 
कसले		K AH S AH L EH  
दायाँ		DH AA  Y AH AAN 
तपाईले		TH AH P AA  IH L EH  
डबल		D AH B AH L AH 
गरौ		G AH R AH UH  
हप्ता		HH AH P AH  TH AA  
सम्मको		S AH M AH  M AH K OH  
मेल		M EH  L AH 
भाँडामा		BA AA N D AH AA M AH AA 
पखाला		P AH KA AA  L AH AA 
गरी		G AH R IH  
अघि		AH GA IH  
अप्ठ्यारो		AH P AH  TA AH  Y AA  R OH  
संलग्न		S AH ML AH G AH  N AH 
लगाउने		L AH G AA  UH N EH  
भनिदिनुहुन्छ		BA AH N IH  DH AH IH N UH  HH AH UH N AH  CHA AH 
पोको		P OH  K AH OH 
तिनीहरु		TH IH  N AH IH HH AH R UH  
टेबुल		T EH  B UH  L AH 
गराएको		G AH R AA  EH K OH  
उसले		UH S AH L EH  
आयो।		AA Y OH  
सिटहरु		S IH  T AH HH AH R UH  
लागी।		L AA  G IH  
मिलाउन		M IH  L AA  UH N AH 
ट्राभलर्स		T AH  R AA  BA AH L AH R AH  S AH 
मूल्यमा		M UH  L AH  Y AH M AA  
पाईन्छ		P AA  IH N AH  CHA AH 
कप		K AH P AH 
बोलाउन		B OH  L AA  UH N AH 
पुरानो		P UH  R AA  N OH  
नजिकैको		N AH JH IH  K AH AH IH K OH  
दर		DH AH R AH 
साथीलाई		S AA  THA IH  L AH AA IH 
रोक्छ		R OH  K AH  CHA AH 
फ्लाइट		PA AH  L AA  IH T AH 
प्रख्यात		P AH  R AH KA AH  Y AA  TH AH 
पुस्तिका		P UH  S AH  TH IH  K AA  
गरिदिनु		G AH R IH  DH AH IH N UH  
ओहो		OH HH OH  
रातीको		R AA  TH IH  K OH  
मुल्य		M UH  L AH  Y AH 
परेको		P AH R EH  K OH  
पत्रिका		P AH TH AH  R IH  K AA  
पछाडि		P AH CHA AA  D IH  
नम्बरमा		N AH M AH  B AH R AH M AA  
दिनु		DH IH  N UH  
छालाको		CHA AA  L AH AA K OH  
खानुहुन्छ		KA AA  N UH  HH AH UH N AH  CHA AH 
होस्।		HH OH  S AH  
सहितको		S AH HH IH  TH AH K OH  
सम्ममा		S AH M AH  M AH M AA  
भेटौंला।		BA EH  T AH UH  ML AA  
भइहाल्छ		BA IH  HH AA  L AH  CHA AH 
तिर्छु।		TH IH  R AH  CHA UH  
जुन		JH UH  N AH 
अण्डा		AH N AH  D AA  
हेर्दैछु।		HH EH  R AH  DH AH IH  CHA UH  
सि		S IH  
पाउरोटी		P AA  UH R OH  T IH  
तिम्रो		TH IH  M AH  R OH  
एघार		EH GA AA  R AH 
हराएको		HH AH R AA  EH K OH  
बोस्टन		B OH  S AH  T AH N AH 
बुकिङ्ग		B UH  K IH  NG AH  G AH 
फ्रेन्च		PA AH  R EH  N AH  CH AH 
खोजिरहेको		KA OH  JH IH  R AH HH EH  K AH OH 
कस्ता		K AH S AH  TH AA  
कलेक्ट		K AH L EH  K AH  T AH 
मनपर्दैन।		M AH N AH P AH R AH  DH AH IH  N AH 
बोलाईदिनुहुन्छ		B OH  L AA  IH DH IH  N UH  HH AH UH N AH  CHA AH 
बेच्ने		B EH  CH AH  N AH EH 
बिक्री		B IH  K AH  R AH IH 
दुखि		DH UH  KA IH  
राख्नुहोस।		R AA  KA AH  N UH  HH OH  S AH 
ट्यांकि		T AH  Y AA  MK IH  
उसको		UH S AH K OH  
अग्लो		AH G AH  L OH  
सुन्तलाको		S UH  N AH  TH AH L AA  K OH  
सिफारिश		S IH  PA AA  R AH IH S AH 
वर्ष		W AH R AH  S AH 
पेट्रोल		P EH  T AH  R OH  L AH 
गल्ती		G AH L AH  TH IH  
अवश्य		AH W AH S AH  Y AH 
हप्ताको		HH AH P AH  TH AA  K OH  
साईज		S AA  IH JH AH 
रुपमा		R UH  P AH M AA  
बोलाउनुहोस।		B OH  L AA  UH N UH  HH AH OH S AH 
जानुपर्छ		JH AA  N UH  P AH R AH  CHA AH 
चाहिंदैन।		CH AA  HH IH  MDH AH AH IH N AH 
खुजुरा		KA UH  JH AH UH R AA  
सीधा		S IH  DHA AA  
यति		Y AH TH IH  
भएर		BA EH  R AH 
पनी		P AH N IH  
नक्सामा		N AH K AH  S AA  M AH AA 
उसोभए		UH S OH  BA EH  
होटलको		HH OH  T AH L AH K AH OH 
विनिमय		W IH  N AH IH M AH Y AH 
तपाईंसित		TH AH P AA  IH MS IH  TH AH 
तपाईँ		TH AH P AA  IHN 
चाहन्छु		CH AA  HH AH N AH  CHA UH  
चाँडै		CH AA N D AH IH  
कोक		K OH  K AH 
कार्डले		K AA  R AH  D AH L EH  
कती		K AH TH IH  
राखिदिन		R AA  KA IH  DH AH IH N AH 
बोल्नुहोस्।		B OH  L AH  N UH  HH AH OH S AH  
ठेगानामा		TA EH  G AA  N AH AA M AH AA 
जाँदा		JH AA N DH AH AA 
कोट		K OH  T AH 
उद्देश्य		UH DH AH  DH EH  S AH  Y AH 
सवारी		S AH W AA  R IH  
मोड्नुहोस्।		M OH  D AH  N UH  HH AH OH S AH  
दुइ		DH UH  IH 
थिए।		THA IH  EH 
गाइड		G AA  IH D AH 
आनन्द		AA N AH N AH  DH AH 
अन्य		AH N AH  Y AH 
हुनेछ		HH UH  N EH  CHA AH 
सिकाउनुहोस्।		S IH  K AA  UH N UH  HH OH  S AH  
रंगमा		R AH MG AH M AA  
त्यसो		TH AH  Y AH S OH  
घाँटी		GA AA N T IH  
सहर		S AH HH AH R AH 
संग्रहालय		S AH MG AH  R AH HH AA  L AH Y AH 
यिनीहरु		Y IH  N AH IH HH AH R UH  
बीमा		B IH  M AA  
बिदा		B IH  DH AA  
बिग्रेको		B IH  G AH  R EH  K OH  
पुन		P UH  N AH 
पर्दैन।		P AH R AH  DH AH IH  N AH 
नुहाउने		N UH  HH AA  UH N EH  
निर्णय		N IH  R AH  N AH Y AH 
ब्याट्री		B AH  Y AA  T AH  R IH  
फ्याक्स		PA AH  Y AA  K AH  S AH 
देशबाट		DH EH  S AH B AA  T AH 
दाहिने		DH AA  HH IH  N EH  
चिन्ह		CH IH  N AH  HH AH 
चिन्ता		CH IH  N AH  TH AA  
गरौँ।		G AH R AH UH N 
सन्चै		S AH N AH  CH AH IH  
रगत		R AH G AH TH AH 
भनि		BA AH N IH  
प्रायजसो		P AH  R AA  Y AH JH AH S OH  
नौं		N AH UH  M
ति		TH IH  
छौं।		CHA AH UH  M
चाहन्छौँ।		CH AA  HH AH N AH  CHA AH UH N 
खाजा		KA AA  JH AH AA 
कपडा		K AH P AH D AA  
अमेरिकी		AH M EH  R IH  K AH IH 
साटिदिनुहुन्छ		S AA  T IH  DH AH IH N UH  HH AH UH N AH  CHA AH 
पठाईदिन		P AH TA AA  IH DH IH  N AH 
दिनमा		DH IH  N AH M AA  
दर्ता		DH AH R AH  TH AA  
तेस्रो		TH EH  S AH  R OH  
चानचुन		CH AA  N AH CH UH  N AH 
एकछीन		EH K AH CHA IH  N AH 
सहित		S AH HH IH  TH AH 
भर्नाशुल्क		BA AH R AH  N AA  S UH  L AH  K AH 
बाँकि		B AA N K IH  
चक्कर		CH AH K AH  K AH R AH 
गर्नुहोस।		G AH R AH  N UH  HH OH  S AH 
गएको		G EH  K OH  
खोल्नुहोस्।		KA OH  L AH  N UH  HH AH OH S AH  
खोज्दै		KA OH  JH AH  DH AH IH  
खालका		KA AA  L AH K AH AA 
आउँनुभयो		AA UHN N UH  BA AH Y OH  
लगाउन		L AH G AA  UH N AH 
मगाएको		M AH G AA  EH K OH  
भेट्टाउन		BA EH  T AH  T AA  UH N AH 
बोलाउनुहोस्।		B OH  L AA  UH N UH  HH AH OH S AH  
दृश्यावलोकन		DH AH R S AH  Y AA  W AH L OH  K AH N AH 
तिर्ने		TH IH  R AH  N EH  
तिर्नुपर्छ		TH IH  R AH  N UH  P AH R AH  CHA AH 
ठाऊँ		TA AA  UHN 
गर्नुभएको		G AH R AH  N UH  BA EH  K OH  
कसलाई		K AH S AH L AA  IH 
राख्ने		R AA  KA AH  N EH  
टाई		T AA  IH 
घुम्न		GA UH  M AH  N AH 
आफै		AA PA AH IH  
हुन्		HH UH  N AH  
हल्ला		HH AH L AH  L AA  
शान्त		S AA  N AH  TH AH 
व्यक्तिगत		W AH  Y AH K AH  TH IH  G AH TH AH 
राखेको		R AA  KA EH  K OH  
भ्रमणमा		BA AH  R AH M AH N AH M AA  
बिर्सेछु।		B IH  R AH  S EH  CHA UH  
बारे		B AA  R EH  
पछाडी		P AH CHA AA  D IH  
कम्बल		K AH M AH  B AH L AH 
उहाँको		UH HH AA N K OH  
हिसाब		HH IH  S AA  B AH 
सम्लग्न		S AH M AH  L AH G AH  N AH 
व्यस्त		W AH  Y AH S AH  TH AH 
लैजान		L AH IH  JH AA  N AH 
ध्यान		DHA AH  Y AA  N AH 
टिकटको		T IH  K AH T AH K OH  
चिठी		CH IH  TA AH IH 
गाह्रो		G AA  HH AH  R OH  
खुल्ला		KA UH  L AH  L AA  
भन्नुहुन्छ		BA AH N AH  N UH  HH AH UH N AH  CHA AH 
बत्ती		B AH TH AH  TH IH  
पेय		P EH  Y AH 
पदार्थ		P AH DH AA  R AH  THA AH 
तेल		TH EH  L AH 
हरायो		HH AH R AA  Y OH  
वरिपरि		W AH R IH  P AH R AH IH 
मुद्रा		M UH  DH AH  R AA  
भन्नुहोस्		BA AH N AH  N UH  HH OH  S AH  
त्यस्तै		TH AH  Y AH S AH  TH AH IH  
वान्ता		W AA  N AH  TH AH AA 
रोल		R OH  L AH 
योर्क		Y OH  R AH  K AH 
पाउँछ		P AA  UHN CHA AH 
चिठ्ठी		CH IH  TA AH  TA AH IH 
गल्फ		G AH L AH  PA AH 
क्लब		K AH  L AH B AH 
केन्द्र		K EH  N AH  DH AH  R AH 
अमेरिकामा		AH M EH  R IH  K AA  M AH AA 
हुनुपर्छ।		HH UH  N AH UH P AH R AH  CHA AH 
माफ गर्नुहोस्।		M AA  PA AH 
बोलाई		B OH  L AA  IH 
प्रहरीलाई		P AH  R AH HH AH R IH  L AA  IH 
प्रवेश		P AH  R AH W EH  S AH 
नास्ता		N AA  S AH  TH AH AA 
सबवे		S AH B AH W EH  
लगिदिनुहुन्छ		L AH G IH  DH AH IH N UH  HH AH UH N AH  CHA AH 
रमणीय		R AH M AH N IH  Y AH 
मिनेटमा		M IH  N EH  T AH M AA  
बस्नु		B AH S AH  N UH  
बजेसम्म		B AH JH EH  S AH M AH  M AH 
बचाऊ।		B AH CH AA  UH 
प्रतिशत		P AH  R AH TH IH  S AH TH AH 
नक्शामा		N AH K AH  S AA  M AH AA 
ती		TH IH  
टिकेटहरु		T IH  K EH  T AH HH AH R UH  
जानुपर्छ।		JH AA  N UH  P AH R AH  CHA AH 
छाला		CHA AA  L AH AA 
चोट		CH OH  T AH 
अस्पतालमा		AH S AH  P AH TH AA  L AH M AH AA 
अवश्य।		AH W AH S AH  Y AH 
हेर्छु।		HH EH  R AH  CHA UH  
साह्रै		S AA  HH AH  R AH IH  
लुगाहरु		L UH  G AA  HH AH R AH UH 
मेसेज		M EH  S AH EH JH AH 
मात्र।		M AA  TH AH  R AH 
बोक्ने		B OH  K AH  N EH  
बेलुकाको		B EH  L UH  K AA  K OH  
बार		B AA  R AH 
बसमा		B AH S AH M AA  
बजे।		B AH JH EH  
प्रदर्शन		P AH  R AH DH AH R AH  S AH N AH 
दिउँसोको		DH AH IWN S OH  K AH OH 
जापानबाट		JH AA  P AH AA N AH B AH AA T AH 
खुकुलो		KA UH  K AH UH L OH  
साथीको		S AA  THA IH  K OH  
रोक्ने		R OH  K AH  N EH  
मात्रै		M AA  TH AH  R AH IH  
पक्का।		P AH K AH  K AA  
एक्लै		EH K AH  L AH IH  
हैन		HH AH IH  N AH 
स्की		S AH  K IH  
सी		S IH  
सहमत		S AH HH AH M AH TH AH 
सर्न		S AH R AH  N AH 
भ्रमणको		BA AH  R AH M AH N AH K OH  
भोलिको		BA OH  L IH  K AH OH 
बज्यो		B AH JH AH  Y OH  
नभएको		N AH BA EH  K OH  
झोलामा		JHA OH  L AA  M AH AA 
जाम		JH AA  M AH 
उनि		UH N IH  
अत्यन्त		AH TH AH  Y AH N AH  TH AH 
हालेको		HH AA  L EH  K OH  
सहरको		S AH HH AH R AH K OH  
लिनु		L IH  N UH  
बुझ्दिन।		B UH  JHA AH  DH IH  N AH 
पायो		P AA  Y OH  
ज्याकेट		JH AH  Y AA  K EH  T AH 
जरुरी		JH AH R UH  R IH  
चिनी		CH IH  N AH IH 
काँटा		K AA N T AH AA 
लिफ्ट		L IH  PA AH  T AH 
रूम		R UH  M AH 
रिजर्बेसन		R IH  JH AH R AH  B EH  S AH N AH 
रमाईलो		R AH M AA  IH L OH  
मे		M EH  
फ्लाईटमा		PA AH  L AA  IH T AH M AH AA 
टोकियोको		T OH  K IH  Y AH OH K AH OH 
चोटी		CH OH  T IH  
गर्मी		G AH R AH  M IH  
अनुरोध		AH N UH  R OH  DHA AH 
हुन्थ्यो।		HH UH  N AH  THA AH  Y OH  
स्टोर		S AH  T OH  R AH 
स्टेशनमा		S AH  T EH  S AH N AH M AA  
बोलाईदिनुहोस्।		B OH  L AA  IH DH IH  N UH  HH AH OH S AH  
बिचमा		B IH  CH AH M AA  
बर्ष		B AH R AH  S AH 
पछी		P AH CHA IH  
छिन्।		CHA IH  N AH  
गर्छ		G AH R AH  CHA AH 
खर्च		KA AH R AH  CH AH 
आउँछ।		AA UHN CHA AH 
हेर्ने		HH EH  R AH  N AH EH 
सायद		S AA  Y AH DH AH 
मोडिनुहोस्।		M OH  D IH  N UH  HH AH OH S AH  
ब्लक		B AH  L AH K AH 
निलो		N IH  L OH  
टायर		T AA  Y AH R AH 
ओपेरा		OH P EH  R AA  
प्रमाणपत्र		P AH  R AH M AA  N AH P AH TH AH  R AH 
पम्प		P AH M AH  P AH 
चोर।		CH OH  R AH 
गाईको		G AA  IH K OH  
आउनुहुन्छ		AA UH N UH  HH AH UH N AH  CHA AH 
हस्ताक्षर		HH AH S AH  TH AA  K AH  S AH R AH 
सेट		S EH  T AH 
सक्छ		S AH K AH  CHA AH 
लाग्यो		L AA  G AH  Y OH  
देख्न		DH EH  KA AH  N AH 
दाग		DH AA  G AH 
त्यही		TH AH  Y AH HH IH  
समयमै		S AH M AH Y AH M AH IH  
लानुहोस्।		L AA  N UH  HH OH  S AH  
रहित		R AH HH IH  TH AH 
मुरि		M UH  R IH  
बस्नुहोस्।		B AH S AH  N UH  HH OH  S AH  
दुखाई		DH UH  KA AA  IH 
दिएको		DH IH  EH K OH  
थिएन।		THA IH  EH N AH 
तपाईंहरु		TH AH P AA  IH MHH AH R UH  
तपाईँले		TH AH P AA  IHN L EH  
आउनु		AA UH N UH  
सोध्न		S OH  DHA AH  N AH 
राखिदिनुहुन्छ		R AA  KA IH  DH AH IH N UH  HH AH UH N AH  CHA AH 
मान्छेहरु		M AA  N AH  CHA EH  HH AH R UH  
भेट्ने		BA EH  T AH  N AH EH 
बसको		B AH S AH K OH  
बर्षको		B AH R AH  S AH K OH  
बजार		B AH JH AA  R AH 
डेजर्ट		D EH  JH AH R AH  T AH 
खालि		KA AA  L IH  
अर्थ		AH R AH  THA AH 
सूचना		S UH  CH AH N AA  
श्याम्पू		S AH  Y AA  M AH  P UH  
महिना		M AH HH IH  N AA  
भेट्टाइन।		BA EH  T AH  T AA  IH N AH 
भनिन्छ		BA AH N IH  N AH  CHA AH 
बेलामा		B EH  L AA  M AH AA 
बेर		B EH  R AH 
बुझ्न		B UH  JHA AH  N AH 
बाटोमा		B AA  T OH  M AH AA 
प्रत्येक		P AH  R AH TH AH  Y EH  K AH 
पैदल		P AH IH  DH AH L AH 
नगदमा		N AH G AH DH AH M AA  
ठ्याक्कै		TA AH  Y AA  K AH  K AH IH  
टिकटहरू		T IH  K AH T AH HH AH R UH  
जाओस्।		JH AA  OH S AH  
कोर्ट		K OH  R AH  T AH 
आरक्षण		AA R AH K AH  S AH N AH 
अडर		AH D AH R AH 
हुन्न		HH UH  N AH  N AH 
स्वागत		S AH  W AA  G AH TH AH 
सरसामान		S AH R AH S AA  M AH AA N AH 
सडक		S AH D AH K AH 
ल्याउन		L AH  Y AA  UH N AH 
रुमाल		R UH  M AA  L AH 
यसबाट		Y AH S AH B AA  T AH 
भएकोले		BA EH  K OH  L AH EH 
पोस्ट		P OH  S AH  T AH 
कागज		K AA  G AH JH AH 
अमेरिकन		AH M EH  R IH  K AH N AH 
सार्न		S AA  R AH  N AH 
बान्ता		B AA  N AH  TH AH AA 
निशुल्क		N IH  S UH  L AH  K AH 
देखाउनु		DH EH  KA AA  UH N UH  
छुट्टाछुट्टै		CHA UH  T AH  T AA  CHA AH UH T AH  T AH IH  
चासो		CH AA  S OH  
गरिसकें।		G AH R IH  S AH K EH  M
ओ		OH 
उच्च		UH CH AH  CH AH 
सुत्ने		S UH  TH AH  N EH  
सक्दो		S AH K AH  DH OH  
शुभरात्री।		S UH  BA AH R AA  TH AH  R IH  
ल्याइदिनुहोस्।		L AH  Y AA  IH DH IH  N UH  HH OH  S AH  
मेशिन		M EH  S IH  N AH 
मिति		M IH  TH AH IH 
भाषामा		BA AA  S AH AA M AH AA 
पुरै		P UH  R AH IH  
डर		D AH R AH 
टेलीफोन		T EH  L IH  PA OH  N AH 
टि		T IH  
जति।		JH AH TH IH  
कहिलेसम्म		K AH HH IH  L EH  S AH M AH  M AH 
अनुमति		AH N UH  M AH TH IH  
अगाडिको		AH G AA  D IH  K OH  
हप्ता।		HH AH P AH  TH AA  
स्वाद		S AH  W AA  DH AH 
सुट		S UH  T AH 
लाग्दैन		L AA  G AH  DH AH IH  N AH 
पाएको		P AA  EH K OH  
दु		DH UH  
त्यहि		TH AH  Y AH HH IH  
कतिचोटी		K AH TH IH  CH OH  T AH IH 
सान		S AA  N AH 
साथ		S AA  THA AH 
राखिदिनुहोस्।		R AA  KA IH  DH AH IH N UH  HH OH  S AH  
राखिएको		R AA  KA IH  EH K OH  
मिल्छ।		M IH  L AH  CHA AH 
महिनाको		M AH HH IH  N AA  K OH  
मध्यम		M AH DHA AH  Y AH M AH 
भैसक्यो।		BA AH IH  S AH K AH  Y OH  
पर्खनुपर्छ		P AH R AH  KA AH N UH  P AH R AH  CHA AH 
त्यहा		TH AH  Y AH HH AA  
गर्नुपर्ने		G AH R AH  N UH  P AH R AH  N EH  
कान		K AA  N AH 
आउनुहोला।		AA UH N UH  HH OH  L AA  
आँखा		AAN KA AA  
हेलो		HH EH  L OH  
साट्ने		S AA  T AH  N EH  
संकलन		S AH MK AH L AH N AH 
बसबाट		B AH S AH B AA  T AH 
बजेर		B AH JH EH  R AH 
फोनमा		PA OH  N AH M AA  
नुन		N UH  N AH 
त्यसपछि		TH AH  Y AH S AH P AH CHA IH  
तुरुन्त		TH UH  R AH UH N AH  TH AH 
तीनवटा		TH IH  N AH W AH T AA  
तिनीहरुलाई		TH IH  N AH IH HH AH R UH  L AA  IH 
चेकआउट		CH EH  K AA  UH T AH 
गर्नेछु।		G AH R AH  N EH  CHA UH  
अन्तर्राष्ट्रिय		AH N AH  TH AH R AH  R AA  S AH  T AH  R IH  Y AH 
हेर्नुहोस्।		HH EH  R AH  N UH  HH OH  S AH  
सेन्टर		S EH  N AH  T AH R AH 
सूची		S UH  CH IH  
सुल्क		S UH  L AH  K AH 
साइजमा		S AA  IH JH AH M AH AA 
समाबेश		S AH M AA  B EH  S AH 
वलेट		W AH L EH  T AH 
वर्षको		W AH R AH  S AH K OH  
लैजानुहोस्।		L AH IH  JH AA  N UH  HH OH  S AH  
लिएको		L IH  EH K OH  
याद		Y AA  DH AH 
यही		Y AH HH IH  
पच्चीस		P AH CH AH  CH IH  S AH 
थप		THA AH P AH 
छल्लिएँ।		CHA AH L AH  L IH  EHN 
चिकेन		CH IH  K EH  N AH 
कार्डबाट		K AA  R AH  D AH B AH AA T AH 
कसो		K AH S OH  
ए।		EH 
एयर		EH Y AH R AH 
हतारमा		HH AH TH AA  R AH M AH AA 
स्वचालित		S AH  W AH CH AA  L IH  TH AH 
सुन्न		S UH  N AH  N AH 
सिधै		S IH  DHA AH AH IH 
सर		S AH R AH 
यहि		Y AH HH IH  
मिलेको		M IH  L EH  K OH  
भर्ना		BA AH R AH  N AA  
भनिदिनुहोस्।		BA AH N IH  DH AH IH N UH  HH OH  S AH  
बेसबल		B EH  S AH B AH L AH 
बिभाग		B IH  BA AA  G AH 
बच्चाको		B AH CH AH  CH AA  K OH  
छुट्टै		CHA UH  T AH  T AH IH  
गजब		G AH JH AH B AH 
एसले		EH S AH L EH  
समाचार		S AH M AA  CH AH AA R AH 
सकिन्छ।		S AH K IH  N AH  CHA AH 
यि		Y IH  
मेलबाट		M EH  L AH B AA  T AH 
मार्ग		M AA  R AH  G AH 
पिउनुहुन्छ		P AH IW N UH  HH AH UH N AH  CHA AH 
परिकार		P AH R IH  K AA  R AH 
धुन		DHA UH  N AH 
देखिने		DH EH  KA IH  N AH EH 
थाह		THA AA  HH AH 
त्यहाँको		TH AH  Y AH HH AA N K OH  
तानाका		TH AA  N AH AA K AH AA 
खुट्टा		KA UH  T AH  T AA  
साधारण		S AA  DHA AH AA R AH N AH 
साँचै		S AA N CH AH IH  
सम्भव		S AH M AH  BA AH W AH 
वाईन		W AA  IH N AH 
रुघा		R UH  GA AA  
मागेको		M AA  G EH  K OH  
बेलुका		B EH  L UH  K AA  
बिचार		B IH  CH AA  R AH 
बत्ति		B AH TH AH  TH IH  
प्याक		P AH  Y AA  K AH 
पाइने		P AA  IH N EH  
पठाउनुहोस्।		P AH TA AA  UH N UH  HH OH  S AH  
दोष		DH OH  S AH 
दुखिरहेको		DH UH  KA IH  R AH HH EH  K OH  
तिमी		TH IH  M AH IH 
तस्वीर		TH AH S AH  W IH  R AH 
तपाईँलाई		TH AH P AA  IHN L AH AA IH 
ट्रान्सफर		T AH  R AA  N AH  S AH PA AH R AH 
ट्याक्सीमा		T AH  Y AA  K AH  S IH  M AH AA 
टुर		T UH  R AH 
जाऔं।		JH AA  AH UN M
खानामा		KA AA  N AH AA M AH AA 
हुन्छु।		HH UH  N AH  CHA AH UH 
लग्यो।		L AH G AH  Y OH  
बटुवा		B AH T UH  W AA  
फाराम		PA AA  R AH AA M AH 
ड्रिंक		D AH  R IH  MK AH 
ठिक्कको।		TA IH  K AH  K AH K OH  
चक्की		CH AH K AH  K IH  
ओटा		OH T AA  
सार्वजनिक		S AA  R AH  W AH JH AH N IH  K AH 
सक्दैन।		S AH K AH  DH AH IH  N AH 
सक्छ।		S AH K AH  CHA AH 
श्रीमान		S AH  R IH  M AA  N AH 
राख्नुहोला।		R AA  KA AH  N UH  HH OH  L AH AA 
भएकोमा		BA EH  K OH  M AA  
बाटोबाट		B AA  T OH  B AH AA T AH 
नजीकै		N AH JH IH  K AH AH IH 
दुईटा		DH UH  IH T AA  
डी		D IH  
जब		JH AH B AH 
छैनन्।		CHA AH IH  N AH N AH  
घरको		GA AH R AH K OH  
खेल्ने		KA EH  L AH  N AH EH 
आम्बुलेन्स		AA M AH  B UH  L EH  N AH  S AH 
स्मिथ		S AH  M IH  THA AH 
विमानस्थलमा		W IH  M AA  N AH S AH  THA AH L AH M AH AA 
लाइनमा		L AA  IH N AH M AH AA 
रुचाउनुहुन्छ		R UH  CH AA  UH N AH UH HH AH UH N AH  CHA AH 
भर्नुहोस्।		BA AH R AH  N UH  HH OH  S AH  
भर्खर		BA AH R AH  KA AH R AH 
बिस		B IH  S AH 
बर्गर		B AH R AH  G AH R AH 
फ्लाईटको		PA AH  L AA  IH T AH K OH  
छौं		CHA AH UH  M
छुट्यो।		CHA UH  T AH  Y OH  
चिकित्सक		CH IH  K AH IH TH AH  S AH K AH 
आलु		AA L UH  
म्याम		M AH  Y AA  M AH 
भाषाको		BA AA  S AH AA K OH  
बनाएको		B AH N AA  EH K OH  
दुख्यो।		DH UH  KA AH  Y OH  
ट्याक्सीबाट		T AH  Y AA  K AH  S IH  B AH AA T AH 
जापानीज		JH AA  P AH AA N IH  JH AH 
सेवाको		S EH  W AA  K OH  
लौ		L AH UH  
महोदय।		M AH HH OH  DH AH Y AH 
बिलमा		B IH  L AH M AA  
नाक		N AA  K AH 
धुने		DHA UH  N EH  
दिनुहोस््।		DH IH  N UH  HH OH  S AH   
तर्फी		TH AH R AH  PA IH  
जापानिज		JH AA  P AH AA N IH  JH AH 
जानुहोस्		JH AA  N UH  HH OH  S AH  
जानलाई		JH AA  N AH L AH AA IH 
छौ।		CHA AH UH  
गाडीमा		G AA  D IH  M AH AA 
खोजेको		KA OH  JH EH  K AH OH 
एकैछिन।		EH K AH IH  CHA AH IH N AH 
उत्पादन		UH TH AH  P AA  DH AH N AH 
अन्तराष्ट्रिय		AH N AH  TH AH R AA  S AH  T AH  R IH  Y AH 
सुन्दा		S UH  N AH  DH AA  
शिकागो		S IH  K AA  G OH  
रङ		R AH NG AH 
बोक्न		B OH  K AH  N AH 
बच्चा		B AH CH AH  CH AA  
पुरा		P UH  R AA  
पुग्छ।		P UH  G AH  CHA AH 
पाँचवटा		P AA N CH AH W AH T AH AA 
देशमा		DH EH  S AH M AA  
त्यसै		TH AH  Y AH S AH IH  
छिर्न		CHA IH  R AH  N AH 
छिट्टै		CHA IH  T AH  T AH AH IH 
ख़ुशी		KA UH  S IH  
कडा		K AH D AA  
आवाज		AA W AA  JH AH 
अहिलेको		AH HH IH  L EH  K OH  
सापटी		S AA  P AH T IH  
संयुक्त		S AH MY UH  K AH  TH AH 
संग्राहलय		S AH MG AH  R AA  HH AH L AH Y AH 
शहरमा		S AH HH AH R AH M AA  
रहोस।		R AH HH OH  S AH 
मनपर्ने		M AH N AH P AH R AH  N EH  
भर्न		BA AH R AH  N AH 
बोल्नुहुन्छ		B OH  L AH  N UH  HH AH UH N AH  CHA AH 
बलेन।		B AH L EH  N AH 
बताउनुहोस्।		B AH TH AA  UH N UH  HH OH  S AH  
पुग्यो।		P UH  G AH  Y OH  
पर्याप्त		P AH R AH  Y AA  P AH  TH AH 
नियम		N IH  Y AH M AH 
झिटी		JHA IH  T AH IH 
छोडेर		CHA OH  D EH  R AH 
गरे		G AH R EH  
गराउनु		G AH R AA  UH N UH  
कुनचाहिं		K UH  N AH CH AA  HH IH  M
एउटै		EW T AH IH  
हेरफेर		HH EH  R AH PA AH EH R AH 
स्थल		S AH  THA AH L AH 
सुप		S UH  P AH 
शुक्रबार		S UH  K AH  R AH B AA  R AH 
विदेशी		W IH  DH EH  S AH IH 
लाग्ने		L AA  G AH  N EH  
भरी		BA AH R IH  
भएका		BA EH  K AA  
बुझेँ।		B UH  JHA EH N 
बरफ		B AH R AH PA AH 
फलफूल		PA AH L AH PA UH  L AH 
नगर्नुहोस्।		N AH G AH R AH  N UH  HH OH  S AH  
डिपार्टमेन्ट		D IH  P AA  R AH  T AH M EH  N AH  T AH 
चाँडो		CH AA N D OH  
कुर्नुहोस्।		K UH  R AH  N AH UH HH OH  S AH  
होस्		HH OH  S AH  
सुत्न		S UH  TH AH  N AH 
साटिदिनुहोस्।		S AA  T IH  DH AH IH N UH  HH OH  S AH  
समात्नुहोस्।		S AH M AA  TH AH  N UH  HH OH  S AH  
व्यापार		W AH  Y AA  P AH AA R AH 
ल्याउनुहोस्।		L AH  Y AA  UH N UH  HH OH  S AH  
लगाउनु		L AH G AA  UH N UH  
मिल्दैन।		M IH  L AH  DH AH AH IH N AH 
मिलाईदिनुहोस्।		M IH  L AA  IH DH AH IH N UH  HH OH  S AH  
मिलाई		M IH  L AA  IH 
भिसा		BA IH  S AA  
भरिदिनुहोला।		BA AH R IH  DH AH IH N UH  HH OH  L AA  
देखाउनुहुन्छ		DH EH  KA AA  UH N UH  HH AH UH N AH  CHA AH 
देखाइदिनुहोस्।		DH EH  KA AA  IH DH IH  N UH  HH OH  S AH  
जाँदैछु।		JH AA N DH AH IH  CHA UH  
छुट्टा		CHA UH  T AH  T AA  
चढ्नुपर्छ		CH AH DA AH  N UH  P AH R AH  CHA AH 
खोकी		KA OH  K IH  
क्षेत्र		K AH  S EH  TH AH  R AH 
उनलाई		UH N AH L AA  IH 
इन।		IH N AH 
आउनुभएको		AA UH N UH  BA EH  K OH  
अहिलेसम्म		AH HH IH  L EH  S AH M AH  M AH 
ह्याम		HH AH  Y AA  M AH 
हट		HH AH T AH 
सोध्नसक्छु		S OH  DHA AH  N AH S AH K AH  CHA UH  
ल		L AH 
मिल्न		M IH  L AH  N AH 
बुझें।		B UH  JHA EH  M
बस्नुहुनेछ		B AH S AH  N UH  HH AH UH N EH  CHA AH 
पराउँछु।		P AH R AA  UHN CHA UH  
दिन।		DH IH  N AH 
दाँया		DH AA N Y AH AA 
थिएँ		THA IH  EHN 
चालीस		CH AA  L IH  S AH 
हाउस		HH AA  UH S AH 
साईजको		S AA  IH JH AH K OH  
सडकको		S AH D AH K AH K OH  
ल्याईदिनुहुन्छ		L AH  Y AA  IH DH IH  N UH  HH AH UH N AH  CHA AH 
येनलाई		Y EH  N AH L AA  IH 
भर्खरै		BA AH R AH  KA AH R AH IH  
बोलाइ		B OH  L AA  IH 
बोर्डिंग		B OH  R AH  D IH  MG AH 
बी		B IH  
बस्नेछु।		B AH S AH  N EH  CHA UH  
बस्दै		B AH S AH  DH AH IH  
बटन		B AH T AH N AH 
फेर्ने		PA EH  R AH  N AH EH 
फर्केर		PA AH R AH  K EH  R AH 
ठाँउलाई		TA AA N UH L AH AA IH 
छिन		CHA IH  N AH 
छन		CHA AH N AH 
खानु		KA AA  N UH  
क्लास		K AH  L AA  S AH 
कुखुराको		K UH  KA AH UH R AA  K OH  
कला		K AH L AA  
कम्पनी		K AH M AH  P AH N IH  
आजराति		AA JH AH R AA  TH IH  
अहिलेनै		AH HH IH  L EH  N AH AH IH 
हावा		HH AA  W AH AA 
सेन्ट।		S EH  N AH  T AH 
विभिन्न		W IH  BA AH IH N AH  N AH 
रोज्छु।		R OH  JH AH  CHA UH  
रेलमा		R EH  L AH M AA  
मिस्टर		M IH  S AH  T AH R AH 
भन्नुभयो		BA AH N AH  N UH  BA AH Y OH  
बुझिन।		B UH  JHA IH  N AH 
पूर्ण		P UH  R AH  N AH 
पार्टी		P AA  R AH  T IH  
ट्राफिक		T AH  R AA  PA IH  K AH 
चीजहरु		CH IH  JH AH HH AH R UH  
चित्र		CH IH  TH AH  R AH 
गाडीको		G AA  D IH  K OH  
गाईड		G AA  IH D AH 
उनीलाई		UH N IH  L AA  IH 
उनको		UH N AH K OH  
उता		UH TH AA  
अँ		AHN 
शुन्य		S UH  N AH  Y AH 
वाइनको		W AA  IH N AH K OH  
लगिदिनुहोस्।		L AH G IH  DH AH IH N UH  HH OH  S AH  
मोटर		M OH  T AH R AH 
मुख		M UH  KA AH 
मगाउन		M AH G AA  UH N AH 
भेट		BA EH  T AH 
बिक्रि		B IH  K AH  R AH IH 
बाट।		B AA  T AH 
बाँया		B AA N Y AH AA 
न्यु		N AH  Y UH  
नलाग्ने		N AH L AA  G AH  N EH  
त्यसमा		TH AH  Y AH S AH M AA  
तारिख		TH AA  R IH  KA AH 
डन		D AH N AH 
चालक		CH AA  L AH K AH 
चलेन।		CH AH L EH  N AH 
गडबडी		G AH D AH B AH D IH  
खोज्न		KA OH  JH AH  N AH 
खानेकुरा		KA AA  N EH  K UH  R AH AA 
कोड		K OH  D AH 
कमजोर		K AH M AH JH OH  R AH 
उपचार		UH P AH CH AA  R AH 
उडानमा		UH D AA  N AH M AH AA 
अत्तर		AH TH AH  TH AH R AH 
हवाईजहाज		HH AH W AA  IH JH AH HH AH AA JH AH 
साबुन		S AA  B UH  N AH 
सबैको		S AH B AH IH  K OH  
लिएँ।		L IH  EHN 
राखेर		R AA  KA EH  R AH 
राखिदिनुहोला।		R AA  KA IH  DH AH IH N UH  HH OH  L AH AA 
प्राय		P AH  R AA  Y AH 
पौडी		P AH UH  D IH  
चेक आउँट समय के हो		CH EH  K AH K AH EH 
गुलियो		G UH  L IH  Y OH  
एकपटक		EH K AH P AH T AH K AH 
आझै		AA JHA AH IH  
आउँदैन।		AA UHN DH AH IH  N AH 
अतिनै		AH TH IH  N AH AH IH 
ह्विस्की		HH AH  W IH  S AH  K AH IH 
हवाइ		HH AH W AA  IH 
हवस्।		HH AH W AH S AH  
स्वीकार्नुहुन्छ		S AH  W IH  K AA  R AH  N UH  HH AH UH N AH  CHA AH 
सक्दैनौं।		S AH K AH  DH AH IH  N AH UH  M
शौचालयको		S AH UH  CH AA  L AH Y AH K OH  
वेल		W EH  L AH 
रेलगाडी		R EH  L AH G AA  D IH  
रुची		R UH  CH IH  
मध्ये		M AH DHA AH  Y EH  
भएपनि		BA EH  P AH N IH  
प्लेट		P AH  L EH  T AH 
पुल		P UH  L AH 
पार्सल		P AA  R AH  S AH L AH 
पार्यो।		P AA  R AH  Y OH  
पारिदिन		P AA  R IH  DH AH IH N AH 
डिस्को		D IH  S AH  K OH  
ठाउँहरु		TA AA  UHN HH AH R UH  
ट्याग		T AH  Y AA  G AH 
जान्नसक्छु		JH AA  N AH  N AH S AH K AH  CHA UH  
गोलिगाँठो		G OH  L IH  G AA N TA AH OH 
क्यामेराको		K AH  Y AA  M EH  R AH AA K OH  
कोठाहरु		K OH  TA AA  HH AH R UH  
आई		AA IH 
हवाईमेल		HH AH W AA  IH M EH  L AH 
हराइरहेको		HH AH R AA  IH R AH HH EH  K OH  
संगीत		S AH MG IH  TH AH 
रकम		R AH K AH M AH 
मंगाउन		M AH MG AA  UH N AH 
भ्रमणहरु		BA AH  R AH M AH N AH HH AH R UH  
बिमानस्थल		B IH  M AA  N AH S AH  THA AH L AH 
बज्यो।		B AH JH AH  Y OH  
पुर्		P UH  R AH  
पाउने		P AA  UH N EH  
देखाइदिनुहुन्थ्यो		DH EH  KA AA  IH DH IH  N UH  HH AH UH N AH  THA AH  Y OH  
दावी		DH AA  W IH  
ठाउँको		TA AA  UHN K OH  
टर्मिनल		T AH R AH  M IH  N AH L AH 
ग्यास		G AH  Y AA  S AH 
होटलमा।		HH OH  T AH L AH M AA  
हुँदै		HH UH N DH AH IH  
स्कच		S AH  K AH CH AH 
सुनेको		S UH  N EH  K OH  
सहरमा		S AH HH AH R AH M AA  
सक्छौ		S AH K AH  CHA AH UH  
सकिने		S AH K IH  N EH  
विमा		W IH  M AA  
विभाग		W IH  BA AA  G AH 
रे		R EH  
मतलब		M AH TH AH L AH B AH 
भाउ		BA AA  UH 
बीचमा		B IH  CH AH M AA  
बिसौनी		B IH  S AH UH  N AH IH 
बिमान		B IH  M AA  N AH 
बाथटब		B AA  THA AH T AH B AH 
बाकसमा		B AA  K AH S AH M AH AA 
बदल्नु		B AH DH AH L AH  N UH  
पाएँ।		P AA  EHN 
पाईने		P AA  IH N EH  
ग्यारेन्टी		G AH  Y AA  R EH  N AH  T IH  
गाढा		G AA  DA AH AA 
गर्छु		G AH R AH  CHA UH  
खाट		KA AA  T AH 
कोर्स		K OH  R AH  S AH 
कृपया।		K AH R P AH Y AA  
कतिजना		K AH TH IH  JH AH N AA  
एकरातको		EH K AH R AA  TH AH K OH  
अठार		AH TA AA  R AH 
हुँदैन।		HH UH N DH AH IH  N AH 
स्टेसनमा		S AH  T EH  S AH N AH M AA  
सस्तोमा		S AH S AH  TH OH  M AA  
विहानको		W IH  HH AA  N AH K OH  
वाटर		W AA  T AH R AH 
लेन्स		L EH  N AH  S AH 
राष्ट्रिय		R AA  S AH  T AH  R IH  Y AH 
यात्रामा		Y AA  TH AH  R AH AA M AH AA 
यतिनै		Y AH TH IH  N AH AH IH 
महिलाको		M AH HH IH  L AA  K OH  
ब्रान्ड		B AH  R AA  N AH  D AH 
प्रश्न		P AH  R AH S AH  N AH 
पेटी		P EH  T IH  
पुग्छ		P UH  G AH  CHA AH 
पाउँ।		P AA  UHN 
पाइन्छ।		P AA  IH N AH  CHA AH 
नून		N UH  N AH 
त्यती		TH AH  Y AH TH IH  
तिर्नु		TH IH  R AH  N UH  
टुक्रा		T UH  K AH  R AA  
जाँच्न		JH AA N CH AH  N AH 
चलेको		CH AH L EH  K OH  
गर्छन्।		G AH R AH  CHA AH N AH  
एकै		EH K AH IH  
आएर		AA EH R AH 
आइतबार		AA IH TH AH B AA  R AH 
अर्कै		AH R AH  K AH IH  
सापट		S AA  P AH T AH 
सबभन्दा		S AH B AH BA AH N AH  DH AA  
सत्तरी		S AH TH AH  TH AH R IH  
सक्छौं।		S AH K AH  CHA AH UH  M
ल्याउनु		L AH  Y AA  UH N UH  
भैरहेको		BA AH IH  R AH HH EH  K OH  
भन्नु		BA AH N AH  N UH  
बनाईदिनुहोस्।		B AH N AA  IH DH IH  N UH  HH OH  S AH  
फर्कने		PA AH R AH  K AH N EH  
पोस्टकार्ड		P OH  S AH  T AH K AA  R AH  D AH 
पर्दैन		P AH R AH  DH AH IH  N AH 
पठाईदिनुहोस्।		P AH TA AA  IH DH IH  N UH  HH OH  S AH  
निषेध		N IH  S EH  DHA AH 
निश्चित		N IH  S AH  CH AH IH TH AH 
निको		N IH  K OH  
त्यो कुन कपडा हो		TH AH  Y OH  HH AH OH 
तिरबाट।		TH IH  R AH B AA  T AH 
तापक्रम		TH AA  P AH K AH  R AH M AH 
ताजा		TH AA  JH AH AA 
तपाईं।		TH AH P AA  IH M
ट्रभेलर्स		T AH  R AH BA EH  L AH R AH  S AH 
जोडी		JH OH  D IH  
जाऊ।		JH AA  UH 
गेम		G EH  M AH 
गरुँ		G AH R UH N 
उहॉ		UH HH AH 
उहाँले		UH HH AA N L EH  
उपहारको		UH P AH HH AA  R AH K OH  
सिक्का		S IH  K AH  K AA  
संगैको		S AH MG AH IH  K OH  
लेराईदिनुहोला।		L EH  R AA  IH DH IH  N UH  HH OH  L AH AA 
लेख्नुहोस्।		L EH  KA AH  N UH  HH OH  S AH  
लेखेको		L EH  KA AH EH K OH  
लेखिएको		L EH  KA IH  EH K OH  
लगिदिन		L AH G IH  DH AH IH N AH 
योर्कको		Y OH  R AH  K AH K AH OH 
यु		Y UH  
मूल्यवान		M UH  L AH  Y AH W AA  N AH 
मीठो		M IH  TA OH  
मद्धे		M AH DH AH  DHA EH  
भेटौँला।		BA EH  T AH UH N L AA  
बोर्डिङ		B OH  R AH  D IH  NG AH 
पोशाकको		P OH  S AA  K AH K AH OH 
तिनीहरुले		TH IH  N AH IH HH AH R UH  L EH  
टेबलमा		T EH  B AH L AH M AA  
जोर		JH OH  R AH 
चम्चा		CH AH M AH  CH AA  
गर्मि		G AH R AH  M IH  
गर्छ।		G AH R AH  CHA AH 
कुनाबाट		K UH  N AA  B AH AA T AH 
कामना।		K AA  M AH N AH AA 
कतिबेर		K AH TH IH  B EH  R AH 
आएको।		AA EH K OH  
सास		S AA  S AH 
साना		S AA  N AH AA 
साँझको		S AA N JHA AH K OH  
सकियो।		S AH K IH  Y OH  
लाईनमा		L AA  IH N AH M AH AA 
लाइट		L AA  IH T AH 
रेस्टुरेन्टमा		R EH  S AH  T UH  R AH EH N AH  T AH M AA  
या		Y AA  
यदी		Y AH DH IH  
महङ्गो		M AH HH AH NG AH  G OH  
भनिदिनुहुन्थ्यो		BA AH N IH  DH AH IH N UH  HH AH UH N AH  THA AH  Y OH  
भइरहेको		BA IH  R AH HH EH  K OH  
बुझ्छु।		B UH  JHA AH  CHA AH UH 
बिफ		B IH  PA AH 
बाहेक		B AA  HH EH  K AH 
प्यासेज		P AH  Y AA  S EH  JH AH 
पर्म		P AH R AH  M AH 
पठाईदिनुहुन्छ		P AH TA AA  IH DH IH  N UH  HH AH UH N AH  CHA AH 
निश्चयनै		N IH  S AH  CH AH Y AH N AH AH IH 
निर्गमद्वार		N IH  R AH  G AH M AH DH AH  W AA  R AH 
दुख्छ		DH UH  KA AH  CHA AH 
तस्बिर		TH AH S AH  B IH  R AH 
डेजर्टको		D EH  JH AH R AH  T AH K OH  
ठक्कर		TA AH K AH  K AH R AH 
चिप्स		CH IH  P AH  S AH 
घण्टाको		GA AH N AH  T AA  K OH  
गर्दैछ।		G AH R AH  DH AH IH  CHA AH 
गयो।		G AH Y OH  
किनेको		K IH  N EH  K OH  
एस		EH S AH 
एम्बुलेन्स		EH M AH  B UH  L EH  N AH  S AH 
एकदिनको		EH K AH DH IH  N AH K OH  
साट्नुहुन्छ		S AA  T AH  N UH  HH AH UH N AH  CHA AH 
समुद्री		S AH M UH  DH AH  R IH  
विसौनीहरु		W IH  S AH UH  N AH IH HH AH R AH UH 
लिनेछु।		L IH  N EH  CHA UH  
लिनुपर्छ		L IH  N UH  P AH R AH  CHA AH 
रुघाको		R UH  GA AA  K OH  
मेरी		M EH  R IH  
भर्ने		BA AH R AH  N EH  
बोल्नु		B OH  L AH  N UH  
बेच्नुहुन्छ		B EH  CH AH  N UH  HH AH UH N AH  CHA AH 
बढि		B AH DA IH  
फ्लइट		PA AH  L IH  T AH 
पेटको		P EH  T AH K OH  
पाउनु		P AA  UH N UH  
नम्बर।		N AH M AH  B AH R AH 
देख्नुभयो		DH EH  KA AH  N UH  BA AH Y OH  
तर्फ		TH AH R AH  PA AH 
जोन		JH OH  N AH 
चक्कु		CH AH K AH  K UH  
खराब		KA AH R AA  B AH 
कन्सर्ट		K AH N AH  S AH R AH  T AH 
उडानको		UH D AA  N AH K OH  
हेरौं।		HH EH  R AH UH  M
हुनु		HH UH  N AH UH 
सिकागो		S IH  K AA  G OH  
साच्चै		S AA  CH AH  CH AH IH  
सराहना		S AH R AA  HH AH N AH AA 
यामादा		Y AA  M AH AA DH AH AA 
मेडियम		M EH  D IH  Y AH M AH 
फस्ट		PA AH S AH  T AH 
प्रस्तुति		P AH  R AH S AH  TH UH  TH IH  
पिरो		P IH  R OH  
पार्कमा		P AA  R AH  K AH M AH AA 
पसलको		P AH S AH L AH K OH  
नगद।		N AH G AH DH AH 
देखिन्छ		DH EH  KA IH  N AH  CHA AH 
टी		T IH  
छूट		CHA UH  T AH 
छुटाएँ।		CHA UH  T AA  EHN 
चोरीको		CH OH  R IH  K AH OH 
घण्टामा		GA AH N AH  T AA  M AH AA 
गडबड		G AH D AH B AH D AH 
खाता		KA AA  TH AH AA 
कोठाबाट		K OH  TA AA  B AH AA T AH 
कहिल्यै		K AH HH IH  L AH  Y AH AH IH 
अंग्रेजीमा		AH MG AH  R EH  JH IH  M AA  
हिडेर		HH IH  D EH  R AH 
हल		HH AH L AH 
सेफ		S EH  PA AH 
सूप		S UH  P AH 
सिटको		S IH  T AH K OH  
सातो		S AA  TH OH  
सडकमा		S AH D AH K AH M AA  
श्रीमती		S AH  R IH  M AH TH AH IH 
रेयर।		R EH  Y AH R AH 
मेले		M EH  L AH EH 
मुक्त		M UH  K AH  TH AH 
मिलेन।		M IH  L EH  N AH 
मिटर		M IH  T AH R AH 
मान्छेले		M AA  N AH  CHA EH  L AH EH 
भने।		BA AH N EH  
बोलाइदिन		B OH  L AA  IH DH IH  N AH 
प्रमुख		P AH  R AH M UH  KA AH 
पुग्नसक्छु		P UH  G AH  N AH S AH K AH  CHA AH UH 
निश्चय		N IH  S AH  CH AH Y AH 
थिच्नुहोस्।		THA IH  CH AH  N UH  HH OH  S AH  
तिर्नुहुन्छ		TH IH  R AH  N UH  HH AH UH N AH  CHA AH 
तपाईं कुन समय ढोका खोल्नुहुन्छ		TH AH P AA  IH MDA OH  K AH AA 
जाऔं		JH AA  AH UN M
छिटै		CHA IH  T AH AH IH 
गोल्फ		G OH  L AH  PA AH 
खातामा		KA AA  TH AH AA M AH AA 
कुराहरु		K UH  R AA  HH AH R AH UH 
कम्पनीको		K AH M AH  P AH N IH  K OH  
कपालको		K AH P AA  L AH K OH  
इस्त्री		IH S AH  TH AH  R IH  
आगलागी		AA G AH L AA  G IH  
अपरेटर		AH P AH R EH  T AH R AH 
होईन		HH OH  IH N AH 
साँढे		S AA N DA EH  
सक्नुहुन्न।		S AH K AH  N UH  HH AH UH N AH  N AH 
शो		S OH  
म्याम।		M AH  Y AA  M AH 
मिस		M IH  S AH 
भोजन		BA OH  JH AH N AH 
भन्नुसहोस्।		BA AH N AH  N UH  S AH HH OH  S AH  
बजेट		B AH JH EH  T AH 
पूरा		P UH  R AA  
पुग्नकोलागि		P UH  G AH  N AH K OH  L AA  G IH  
पुगेन।		P UH  G EH  N AH 
पत्ता		P AH TH AH  TH AA  
देश		DH EH  S AH 
देब्रे		DH EH  B AH  R AH EH 
दुध		DH UH  DHA AH 
त्यस		TH AH  Y AH S AH 
तपाईंलाइ		TH AH P AA  IH ML AH AA IH 
जूस		JH UH  S AH 
जुलाई		JH UH  L AA  IH 
जानुभएको		JH AA  N UH  BA EH  K OH  
चारवटा		CH AA  R AH W AH T AH AA 
गरौँ		G AH R AH UH N 
गरिन्छ।		G AH R IH  N AH  CHA AH 
किन्छु।		K IH  N AH  CHA UH  
ओर्लिन्छु।		OH R AH  L IH  N AH  CHA UH  
एउटाकोठा		EW T AA  K OH  TA AH AA 
अस्सी		AH S AH  S IH  
अरू		AH R UH  
हुनुभयो		HH UH  N AH UH BA AH Y OH  
स्यान्डविच		S AH  Y AA  N AH  D AH W IH  CH AH 
श्रेणीको		S AH  R EH  N IH  K OH  
वास्तवमा		W AA  S AH  TH AH W AH M AH AA 
लाईन		L AA  IH N AH 
लगाउनुपर्छ		L AH G AA  UH N UH  P AH R AH  CHA AH 
रोकिन्छ		R OH  K IH  N AH  CHA AH 
रेष्टुरेन्ट		R EH  S AH  T UH  R AH EH N AH  T AH 
राम्रै		R AA  M AH  R AH IH  
रात्री		R AA  TH AH  R IH  
मेरोकोठा		M EH  R OH  K AH OH TA AA  
भैरहेछ।		BA AH IH  R AH HH EH  CHA AH 
भर		BA AH R AH 
बोल्दैहुनुहुन्छ		B OH  L AH  DH AH IH  HH UH  N AH UH HH AH UH N AH  CHA AH 
प्रमाण		P AH  R AH M AA  N AH 
नजीक		N AH JH IH  K AH 
तपाईसंग		TH AH P AA  IH S AH MG AH 
तपाँइको		TH AH P AA N IH K OH  
डाक्टरलाई		D AA  K AH  T AH R AH L AH AA IH 
जानुहोला		JH AA  N UH  HH OH  L AH AA 
जाँछ		JH AA N CHA AH 
चेकहरु		CH EH  K AH HH AH R UH  
चाहेको		CH AA  HH EH  K OH  
चल्ने		CH AH L AH  N EH  
चलिरहेको		CH AH L IH  R AH HH EH  K OH  
गर्दैहुनुहुन्छ		G AH R AH  DH AH IH  HH UH  N AH UH HH AH UH N AH  CHA AH 
गरौं।		G AH R AH UH  M
गरिरहेको		G AH R IH  R AH HH EH  K OH  
खिचिदिनुहुन्छ		KA IH  CH AH IH DH AH IH N UH  HH AH UH N AH  CHA AH 
खानको		KA AA  N AH K OH  
खसालें।		KA AH S AA  L EH  M
ख		KA AH 
कोसेली		K OH  S EH  L IH  
काममा।		K AA  M AH M AH AA 
कल।		K AH L AH 
कलम		K AH L AH M AH 
उस्तै		UH S AH  TH AH IH  
साटिदिन		S AA  T IH  DH AH IH N AH 
समान		S AH M AA  N AH 
सटही		S AH T AH HH IH  
सक्छौँ		S AH K AH  CHA AH UH N 
शब्द		S AH B AH  DH AH 
लिस्ट		L IH  S AH  T AH 
लागेन।		L AA  G EH  N AH 
राम्रा		R AA  M AH  R AH AA 
राजदूतावासमा		R AA  JH AH DH UH  TH AH AA W AH AA S AH M AH AA 
रक्तचाप		R AH K AH  TH AH CH AA  P AH 
महिला		M AH HH IH  L AA  
बिहानी		B IH  HH AA  N AH IH 
प्रथम		P AH  R AH THA AH M AH 
पारिदिनुहोला।		P AA  R IH  DH AH IH N UH  HH OH  L AH AA 
पाँचको		P AA N CH AH K OH  
पसलहरु		P AH S AH L AH HH AH R UH  
तिमीले		TH IH  M AH IH L EH  
ड्राई		D AH  R AA  IH 
डि		D IH  
ट्रेनको		T AH  R EH  N AH K OH  
जुत्ताको		JH UH  TH AH  TH AA  K OH  
चिट्ठी		CH IH  T AH  TA AH IH 
चाहीं		CH AA  HH IH  M
गाडीले		G AA  D IH  L EH  
क्षेत्रमा		K AH  S EH  TH AH  R AH M AA  
क्षेत्रको		K AH  S EH  TH AH  R AH K OH  
कोशिस		K OH  S IH  S AH 
कही		K AH HH IH  
आरक्षित		AA R AH K AH  S IH  TH AH 
हिलटन		HH IH  L AH T AH N AH 
स्टपमा		S AH  T AH P AH M AA  
सादा		S AA  DH AH AA 
सर्।		S AH R AH  
सर्ट		S AH R AH  T AH 
विहान		W IH  HH AA  N AH 
लेख्ने		L EH  KA AH  N AH EH 
लेखिदिनुहोला।		L EH  KA IH  DH AH IH N UH  HH OH  L AA  
लिईदिन		L IH  IH DH AH IH N AH 
लान		L AA  N AH 
रोक्न		R OH  K AH  N AH 
राख्नु		R AA  KA AH  N UH  
राख्छु।		R AA  KA AH  CHA UH  
याइदिनुहोस्।		Y AA  IH DH IH  N UH  HH OH  S AH  
बेलुकीको		B EH  L UH  K IH  K OH  
बाजी		B AA  JH IH  
बधाई		B AH DHA AA  IH 
फ्राई		PA AH  R AA  IH 
फ्रन्ट		PA AH  R AH N AH  T AH 
पठाइदिन		P AH TA AA  IH DH IH  N AH 
निम्तो		N IH  M AH  TH OH  
दोश्रो		DH OH  S AH  R AH OH 
ठाऊ		TA AA  UH 
चालिस		CH AA  L IH  S AH 
खोल्नुहुन्छ		KA OH  L AH  N UH  HH AH UH N AH  CHA AH 
खानुहोस्।		KA AA  N UH  HH OH  S AH  
केबल		K EH  B AH L AH 
कसको		K AH S AH K OH  
हूँ।		HH UH N 
स्कच्		S AH  K AH CH AH  
सुनेर		S UH  N EH  R AH 
सुजुकी		S UH  JH AH UH K IH  
सजिलै		S AH JH IH  L AH AH IH 
लस्		L AH S AH  
रे।		R EH  
रेष्टुराँ		R EH  S AH  T UH  R AA N 
रक		R AH K AH 
माथिल्लो		M AA  THA IH  L AH  L OH  
भुमिगत		BA UH  M IH  G AH TH AH 
भिडियो		BA IH  D AH IH Y OH  
भवनको		BA AH W AH N AH K OH  
भरिया		BA AH R IH  Y AA  
बेस		B EH  S AH 
बेरिदिनुहुन्छ		B EH  R IH  DH AH IH N UH  HH AH UH N AH  CHA AH 
पुगिन्छ		P UH  G IH  N AH  CHA AH 
पार्न		P AA  R AH  N AH 
पढ्न		P AH DA AH  N AH 
पठाउने		P AH TA AA  UH N EH  
पठाईदिन्छु।		P AH TA AA  IH DH IH  N AH  CHA UH  
देशको		DH EH  S AH K OH  
तलामा		TH AH L AA  M AH AA 
जुस।		JH UH  S AH 
जानसक्छु		JH AA  N AH S AH K AH  CHA UH  
जाऔँ।		JH AA  AH UNN 
छौँ।		CHA AH UH N 
छोडेको		CHA OH  D EH  K AH OH 
चेकले		CH EH  K AH L AH EH 
ग्याँस		G AH  Y AA N S AH 
खारिज		KA AA  R IH  JH AH 
कुराको		K UH  R AA  K OH  
काउन्टरमा		K AA  UH N AH  T AH R AH M AH AA 
कम्मल		K AH M AH  M AH L AH 
अफ		AH PA AH 
हेर्दै		HH EH  R AH  DH AH IH  
हामीसित		HH AA  M IH  S AH IH TH AH 
सस		S AH S AH 
सक्नुहुन्न		S AH K AH  N UH  HH AH UH N AH  N AH 
शुरुङ्गमार्गको		S UH  R AH UH NG AH  G AH M AA  R AH  G AH K OH  
व्यक्तिको		W AH  Y AH K AH  TH IH  K OH  
राज्य		R AA  JH AH  Y AH 
भएन		BA EH  N AH 
बूक		B UH  K AH 
बिशेषता		B IH  S EH  S AH TH AA  
बापत		B AA  P AH TH AH 
बनाईदिन		B AH N AA  IH DH IH  N AH 
फ्रइट		PA AH  R IH  T AH 
फर्कनुहोस्।		PA AH R AH  K AH N UH  HH OH  S AH  
पुस्तक		P UH  S AH  TH AH K AH 
पर्खिनुहोस्।		P AH R AH  KA IH  N UH  HH OH  S AH  
नपर्ने		N AH P AH R AH  N EH  
देखेर		DH EH  KA AH EH R AH 
देखिनु		DH EH  KA IH  N UH  
दियो।		DH IH  Y OH  
तारिकको		TH AA  R IH  K AH K OH  
डिपोजिट		D IH  P OH  JH AH IH T AH 
टेलिग्राम		T EH  L IH  G AH  R AA  M AH 
चुप		CH UH  P AH 
चाहिएको		CH AA  HH IH  EH K OH  
गेटमा		G EH  T AH M AA  
गम्भीर		G AH M AH  BA IH  R AH 
खुल्ने		KA UH  L AH  N EH  
खास		KA AA  S AH 
खानुहोला।		KA AA  N UH  HH OH  L AH AA 
खाए		KA AA  EH 
क्यामरा		K AH  Y AA  M AH R AH AA 
केटा		K EH  T AA  
कारण		K AA  R AH N AH 
काट्नुहोस्।		K AA  T AH  N UH  HH OH  S AH  
एल		EH L AH 
सुन		S UH  N AH 
सट्टा		S AH T AH  T AA  
वस्तु		W AH S AH  TH UH  
लैजानको		L AH IH  JH AA  N AH K OH  
लिमोजिन		L IH  M OH  JH AH IH N AH 
लण्डन		L AH N AH  D AH N AH 
मिलाईदिनुहोला।		M IH  L AA  IH DH AH IH N UH  HH OH  L AH AA 
फर्किने		PA AH R AH  K IH  N EH  
पार		P AA  R AH 
पर्यो		P AH R AH  Y OH  
नियमित		N IH  Y AH M AH IH TH AH 
दोहोर्याउन		DH OH  HH AH OH R AH  Y AA  UH N AH 
तपाइलाई		TH AH P AA  IH L AH AA IH 
ड्रेस		D AH  R EH  S AH 
ठट्टा		TA AH T AH  T AA  
ट्यक्सी		T AH  Y AH K AH  S IH  
टिभीमा		T IH  BA AH IH M AA  
जापानि		JH AA  P AH AA N IH  
घुम्ने		GA UH  M AH  N EH  
गरिदिनुहोस।		G AH R IH  DH AH IH N UH  HH OH  S AH 
कोसिस		K OH  S IH  S AH 
किनभने		K IH  N AH BA AH N EH  
काँचो		K AA N CH OH  
कतिको		K AH TH IH  K OH  
एसी		EH S IH  
आफ्नै		AA PA AH  N AH IH  
आगमन		AA G AH M AH N AH 
अनौठो		AH N AH UH  TA OH  
हरु		HH AH R UH  
हतार		HH AH TH AA  R AH 
स्वतन्त्र		S AH  W AH TH AH N AH  TH AH  R AH 
स्ट्रीट		S AH  T AH  R IH  T AH 
स्टेशनबाट		S AH  T EH  S AH N AH B AA  T AH 
सिक्काहरु		S IH  K AH  K AA  HH AH R UH  
सामग्री		S AA  M AH G AH  R IH  
साटिदिनु		S AA  T IH  DH AH IH N UH  
सजावट		S AH JH AA  W AH T AH 
सक्कली		S AH K AH  K AH L IH  
शनिबार		S AH N IH  B AA  R AH 
लाग्ला		L AA  G AH  L AH AA 
रेगुलर		R EH  G UH  L AH R AH 
मिनेट।		M IH  N EH  T AH 
मध्य		M AH DHA AH  Y AH 
बेल्ट		B EH  L AH  T AH 
बेकन		B EH  K AH N AH 
बस्टन		B AH S AH  T AH N AH 
बसेर		B AH S EH  R AH 
बरु		B AH R UH  
बनाइदिनुहोला।		B AH N AA  IH DH IH  N UH  HH OH  L AH AA 
बदल्नुपर्छ		B AH DH AH L AH  N UH  P AH R AH  CHA AH 
प्रयास		P AH  R AH Y AA  S AH 
पोलेको		P OH  L EH  K AH OH 
पेन		P EH  N AH 
पाउण्ड		P AA  UH N AH  D AH 
पढ्दैछु।		P AH DA AH  DH AH IH  CHA UH  
पख्नुहोस्।		P AH KA AH  N UH  HH OH  S AH  
नामको		N AA  M AH K OH  
नाटक		N AA  T AH K AH 
धेत्तेरिका।		DHA EH  TH AH  TH AH EH R IH  K AA  
दुईजनाको		DH UH  IH JH AH N AA  K OH  
दयालु		DH AH Y AA  L UH  
ढल्काउन		DA AH L AH  K AA  UH N AH 
ठाँउ		TA AA N UH 
टूरको		T UH  R AH K OH  
झ्यालमा		JHA AH  Y AA  L AH M AH AA 
छन।		CHA AH N AH 
चिल्लो		CH IH  L AH  L OH  
चाहिं।		CH AA  HH IH  M
कुपन		K UH  P AH N AH 
कार्यक्रमको		K AA  R AH  Y AH K AH  R AH M AH K OH  
कार्डको		K AA  R AH  D AH K OH  
कम्मर		K AH M AH  M AH R AH 
आकारको		AA K AA  R AH K OH  
आएन।		AA EH N AH 
आइ		AA IH 
हेयर		HH EH  Y AH R AH 
स्विटर		S AH  W IH  T AH R AH 
सोमबार		S OH  M AH B AA  R AH 
सेवा।		S EH  W AA  
साइड		S AA  IH D AH 
सांगीतिक		S AA  MG IH  TH AH IH K AH 
सट्टामा		S AH T AH  T AA  M AH AA 
वियर		W IH  Y AH R AH 
लेख्न		L EH  KA AH  N AH 
राखि		R AA  KA IH  
योग्य		Y OH  G AH  Y AH 
येनको		Y EH  N AH K OH  
मेरोलागि		M EH  R OH  L AA  G IH  
मान्य		M AA  N AH  Y AH 
भन्नुभएको		BA AH N AH  N UH  BA EH  K OH  
ब्यक्ती		B AH  Y AH K AH  TH IH  
बाँयातिर		B AA N Y AH AA TH IH  R AH 
पोशाक		P OH  S AA  K AH 
पिउनको		P AH IW N AH K OH  
पठाईदिनुहोला।		P AH TA AA  IH DH IH  N UH  HH OH  L AH AA 
न्यूयोर्क		N AH  Y UH  Y OH  R AH  K AH 
नी		N IH  
नया		N AH Y AA  
तारिखमा		TH AA  R IH  KA AH M AH AA 
ठिक्क		TA IH  K AH  K AH 
ट्रावल		T AH  R AA  W AH L AH 
टोस्ट		T OH  S AH  T AH 
जती		JH AH TH IH  
छेउमा		CHA AH EW M AA  
छाडिदिनुहोला।		CHA AA  D IH  DH AH IH N UH  HH OH  L AH AA 
चेकईन		CH EH  K IH  N AH 
गर्छौं।		G AH R AH  CHA AH UH  M
गरेन।		G AH R EH  N AH 
केचप		K EH  CH AH P AH 
कत्तिको		K AH TH AH  TH IH  K OH  
कतिवर्षको		K AH TH IH  W AH R AH  S AH K OH  
औंठी		AH UN MTA IH  
ओर्लिने		OH R AH  L IH  N EH  
ओर्लन		OH R AH  L AH N AH 
एकलाई		EH K AH L AA  IH 
उचित		UH CH IH  TH AH 
आईपुग्छ		AA IH P UH  G AH  CHA AH 
समस्यामा		S AH M AH S AH  Y AA  M AH AA 
सधैं		S AH DHA AH IH  M
विश्वास		W IH  S AH  W AA  S AH 
लाग्नु		L AA  G AH  N UH  
रेड		R EH  D AH 
यतातिर		Y AH TH AA  TH IH  R AH 
भुलेछु।		BA UH  L EH  CHA AH UH 
भनी		BA AH N IH  
बस्तु		B AH S AH  TH UH  
बनाउनुहोस्।		B AH N AA  UH N UH  HH OH  S AH  
बनाईदिनुहुन्छ		B AH N AA  IH DH IH  N UH  HH AH UH N AH  CHA AH 
प्वाल		P AH  W AA  L AH 
प्रिसक्रिपसन		P AH  R IH  S AH K AH  R AH IH P AH S AH N AH 
प्रसिद्ध		P AH  R AH S IH  DH AH  DHA AH 
पुनपक्का		P UH  N AH P AH K AH  K AA  
पातलो		P AA  TH AH L OH  
दिएकोमा		DH IH  EH K OH  M AA  
तौल		TH AH UH  L AH 
तिस		TH IH  S AH 
तारिखको		TH AA  R IH  KA AH K OH  
डेस्कमा		D EH  S AH  K AH M AA  
टिप्न		T IH  P AH  N AH 
जुत्ताहरु		JH UH  TH AH  TH AA  HH AH R AH UH 
जहाँ		JH AH HH AA N 
चेकलाई		CH EH  K AH L AA  IH 
घाउ		GA AA  UH 
ग्रिन		G AH  R IH  N AH 
गर्नुभयो।		G AH R AH  N UH  BA AH Y OH  
खुला		KA UH  L AA  
खान्छु।		KA AA  N AH  CHA UH  
केक		K EH  K AH 
कृपाया		K AH R P AA  Y AH AA 
किसिमका		K IH  S AH IH M AH K AA  
कमिज		K AH M IH  JH AH 
औपचारिक		AH UN P AH CH AA  R IH  K AH 
उत्तर		UH TH AH  TH AH R AH 
आकस्मिक		AA K AH S AH  M IH  K AH 
आइपुगेको		AA IH P UH  G EH  K OH  
होसियार		HH OH  S IH  Y AA  R AH 
हेरिरहेको		HH EH  R IH  R AH HH AH EH K OH  
हाम		HH AA  M AH 
हन्छ।		HH AH N AH  CHA AH 
स्क्वायर		S AH  K AH  W AA  Y AH R AH 
सोडा		S OH  D AA  
सेन्टको		S EH  N AH  T AH K OH  
सरुवा		S AH R UH  W AA  
समेत		S AH M EH  TH AH 
लोकल		L OH  K AH L AH 
लगाउनुहोस्।		L AH G AA  UH N UH  HH OH  S AH  
रुट		R UH  T AH 
मोड्नुहोला।		M OH  D AH  N UH  HH AH OH L AA  
मिलाईदिनुहुन्छ		M IH  L AA  IH DH AH IH N UH  HH AH UH N AH  CHA AH 
महङंगो		M AH HH AH NG AH MG OH  
भ्रमणहरू		BA AH  R AH M AH N AH HH AH R UH  
भइरहेछ।		BA IH  R AH HH EH  CHA AH 
बोल्दै		B OH  L AH  DH AH IH  
बक्स		B AH K AH  S AH 
पेटमा		P EH  T AH M AA  
पुलिस		P UH  L IH  S AH 
पुग्छौं		P UH  G AH  CHA AH AH UH M
पानीको		P AA  N IH  K OH  
पछिको		P AH CHA IH  K OH  
पछाडिको		P AH CHA AA  D IH  K OH  
नी।		N IH  
निक्कै		N IH  K AH  K AH AH IH 
नाकबाट		N AA  K AH B AH AA T AH 
दाँयातिर		DH AA N Y AH AA TH IH  R AH 
दस्तखत		DH AH S AH  TH AH KA AH TH AH 
तपाईंको भ्रमणको उदेश्य के हो 		TH AH P AA  IH MK OH  K EH  
तकिया		TH AH K IH  Y AA  
टूरहरु		T UH  R AH HH AH R AH UH 
छौँ		CHA AH UH N 
चेकमा		CH EH  K AH M AA  
चलाउने		CH AH L AA  UH N EH  
गरेका		G AH R EH  K AA  
गरिदिनुहोस्		G AH R IH  DH AH IH N UH  HH OH  S AH  
खेलौना		KA EH  L AH UH  N AA  
एम		EH M AH 
एन		EH N AH 
आउनुहोस्		AA UH N UH  HH OH  S AH  
सुश्री		S UH  S AH  R IH  
सिट।		S IH  T AH 
सिटी		S IH  T AH IH 
सहन		S AH HH AH N AH 
सर्भीस		S AH R AH  BA IH  S AH 
सन		S AH N AH 
संगित		S AH MG IH  TH AH 
शावर		S AA  W AH R AH 
व्हिस्की		W AH  HH IH  S AH  K AH IH 
विभागमा		W IH  BA AA  G AH M AH AA 
वस्तुहरु		W AH S AH  TH UH  HH AH R AH UH 
लगाएको		L AH G AA  EH K OH  
रात्रि		R AA  TH AH  R IH  
यात्रु		Y AA  TH AH  R UH  
यसबारे		Y AH S AH B AA  R EH  
मुटु		M UH  T AH UH 
भेटौंल		BA EH  T AH UH  ML AH 
भरिदीनुहोस्।		BA AH R IH  DH AH IH N UH  HH OH  S AH  
भनेर।		BA AH N EH  R AH 
बेड		B EH  D AH 
बिच		B IH  CH AH 
बाहुला		B AA  HH UH  L AH AA 
बल		B AH L AH 
फोहोर		PA OH  HH AH OH R AH 
फेर्नुहोस्।		PA EH  R AH  N UH  HH OH  S AH  
प्रतिक्षा		P AH  R AH TH IH  K AH  S AA  
प्याज		P AH  Y AA  JH AH 
पुरुषको		P UH  R AH UH S AH K OH  
पर		P AH R AH 
न्यानो		N AH  Y AA  N OH  
दिउसोको		DH AH IW S OH  K AH OH 
दाह्री		DH AA  HH AH  R IH  
ढाड		DA AA  D AH 
टोकियोबाट		T OH  K IH  Y AH OH B AA  T AH 
छोरा		CHA OH  R AA  
चाहिने		CH AA  HH IH  N EH  
घाइते		GA AA  IH TH EH  
घन्टाको		GA AH N AH  T AA  K OH  
गाइड्		G AA  IH D AH  
खाएको		KA AA  EH K OH  
के भयो		K EH  
काममा		K AA  M AH M AH AA 
कागती		K AA  G AH TH IH  
कसरी  जान सक्छु		K AH S AH R IH  S AH K AH  CHA UH  
औजार		AH UN JH AA  R AH 
एकको		EH K AH K OH  
इन्		IH N AH  
आसपासमा		AA S AH P AA  S AH M AH AA 
आएँ।		AA EHN 
आउनुभयो		AA UH N UH  BA AH Y OH  
आउँदै		AA UHN DH AH IH  
हुनसक्छ।		HH UH  N AH S AH K AH  CHA AH 
हुँ		HH UH N 
हामीकहाँ		HH AA  M IH  K AH HH AH AAN 
हफ्ता		HH AH PA AH  TH AA  
स्वादिलो		S AH  W AA  DH IH  L OH  
सिरानी		S IH  R AA  N AH IH 
सिद्धियो।		S IH  DH AH  DHA AH IH Y OH  
सब		S AH B AH 
सत्र		S AH TH AH  R AH 
विमान		W IH  M AA  N AH 
रिजर्ब		R IH  JH AH R AH  B AH 
राख्दिनुहुन्छ		R AA  KA AH  DH IH  N UH  HH AH UH N AH  CHA AH 
रहन्छ		R AH HH AH N AH  CHA AH 
यहाँलाई		Y AH HH AA N L AH AA IH 
मिनिरल		M IH  N AH IH R AH L AH 
माइलेज		M AA  IH L EH  JH AH 
भिजा		BA IH  JH AA  
भागमा		BA AA  G AH M AH AA 
भरिदिनुहुन्छ		BA AH R IH  DH AH IH N UH  HH AH UH N AH  CHA AH 
ब्रेक		B AH  R EH  K AH 
बुधबार		B UH  DHA AH B AA  R AH 
बारमा		B AA  R AH M AH AA 
बलियो		B AH L IH  Y OH  
बनाउने		B AH N AA  UH N EH  
फेर्नुपर्छ		PA EH  R AH  N UH  P AH R AH  CHA AH 
फिलिम		PA IH  L AH IH M AH 
पूरै		P UH  R AH IH  
पर्खनुहुन्छ		P AH R AH  KA AH N UH  HH AH UH N AH  CHA AH 
नुहाउन		N UH  HH AA  UH N AH 
नरम		N AH R AH M AH 
देख्नुहुनेछ।		DH EH  KA AH  N UH  HH AH UH N AH EH CHA AH 
दुरीको		DH UH  R IH  K OH  
थिच्नुहोला।		THA IH  CH AH  N UH  HH OH  L AA  
त्यो कति बेला		TH AH  Y OH  
त्याती		TH AH  Y AA  TH IH  
डग		D AH G AH 
ज्वोरो		JH AH  W OH  R AH OH 
जाँच्नुहोस्।		JH AA N CH AH  N UH  HH OH  S AH  
छीन		CHA IH  N AH 
छलफल		CHA AH L AH PA AH L AH 
चढेर		CH AH DA EH  R AH 
गोटा		G OH  T AA  
खोलिदिनुहुन्छ		KA OH  L IH  DH AH IH N UH  HH AH UH N AH  CHA AH 
क्यामर		K AH  Y AA  M AH R AH 
कोठामै		K OH  TA AA  M AH IH  
कुर्नुपर्छ		K UH  R AH  N AH UH P AH R AH  CHA AH 
कमिसन		K AH M IH  S AH N AH 
ईन		IH N AH 
आवश्यकता		AA W AH S AH  Y AH K AH TH AA  
हुनुहुन्थ्यो		HH UH  N AH UH HH AH UH N AH  THA AH  Y OH  
सामान्य		S AA  M AH AA N AH  Y AH 
सक्नुहुँन्छ		S AH K AH  N UH  HH AH UHN N AH  CHA AH 
लेखिदिन		L EH  KA IH  DH AH IH N AH 
लग्न		L AH G AH  N AH 
मिलाउनु		M IH  L AA  UH N UH  
मंगाएको		M AH MG AA  EH K OH  
भ्रमणलाई		BA AH  R AH M AH N AH L AA  IH 
भरेर		BA AH R EH  R AH 
भएछ।		BA EH  CHA AH 
बीसको		B IH  S AH K OH  
बिग्रिने		B IH  G AH  R AH IH N EH  
बस्नुपर्छ		B AH S AH  N UH  P AH R AH  CHA AH 
बन्छ		B AH N AH  CHA AH 
बजेतिर		B AH JH EH  TH IH  R AH 
फोनको		PA OH  N AH K AH OH 
प्रयोगको		P AH  R AH Y OH  G AH K AH OH 
पेपर		P EH  P AH R AH 
पेट्रोलबाट		P EH  T AH  R OH  L AH B AA  T AH 
पुरुष		P UH  R AH UH S AH 
पार्टीमा		P AA  R AH  T IH  M AH AA 
पाउँछु		P AA  UHN CHA UH  
पाँचौं		P AA N CH AH UH  M
परिक्षण		P AH R IH  K AH  S AH N AH 
द्रुत		DH AH  R UH  TH AH 
देखेको		DH EH  KA AH EH K OH  
दुर्घटनाको		DH UH  R AH  GA AH T AH N AA  K OH  
दया		DH AH Y AA  
द		DH AH 
तपाईसँग		TH AH P AA  IH S AHN G AH 
तपाईं लाई कस्तो लाग्यो		TH AH P AA  IH ML AH AA G AH  Y OH  
डिनर		D IH  N AH R AH 
टोक्यो।		T OH  K AH  Y AH OH 
जीसँग		JH IH  S AHN G AH 
जाँदैछौँ		JH AA N DH AH IH  CHA AH UH N 
छेउको		CHA AH EW K OH  
चल्दैन।		CH AH L AH  DH AH IH  N AH 
गहिरो		G AH HH IH  R OH  
खोल्ने		KA OH  L AH  N EH  
खोज्नु		KA OH  JH AH  N UH  
क्लासको		K AH  L AA  S AH K OH  
कार्डले।		K AA  R AH  D AH L EH  
कार्डमा		K AA  R AH  D AH M AH AA 
कारको		K AA  R AH K OH  
काट्न		K AA  T AH  N AH 
कम्पनीमा		K AH M AH  P AH N IH  M AA  
ककटेल		K AH K AH T EH  L AH 
एयरपोर्ट		EH Y AH R AH P OH  R AH  T AH 
उत्तम।		UH TH AH  TH AH M AH 
उत्कृष्ट		UH TH AH  K AH R S AH  T AH 
आफुलाई		AA PA UH  L AA  IH 
आइरहेको		AA IH R AH HH EH  K OH  
अनुभव		AH N UH  BA AH W AH 
अटाउने		AH T AA  UH N EH  
हुनुहुन्न।		HH UH  N AH UH HH AH UH N AH  N AH 
हिउँ		HH AH IWN 
सोच्न		S OH  CH AH  N AH 
समयतालिका		S AH M AH Y AH TH AA  L IH  K AH AA 
सकेन।		S AH K EH  N AH 
व्यवस्था		W AH  Y AH W AH S AH  THA AA  
वालेट		W AA  L EH  T AH 
लाख		L AA  KA AH 
लम्बाई		L AH M AH  B AA  IH 
रहेछ		R AH HH EH  CHA AH 
योर्कमा		Y OH  R AH  K AH M AA  
मेलद्वारा		M EH  L AH DH AH  W AA  R AH AA 
मिनाहा		M IH  N AA  HH AH AA 
मास्टर		M AA  S AH  T AH R AH 
मरो		M AH R OH  
बोकेर		B OH  K EH  R AH 
बिना		B IH  N AA  
बिचारमा		B IH  CH AA  R AH M AH AA 
फोनबाट		PA OH  N AH B AA  T AH 
प्रतिलिपि		P AH  R AH TH IH  L AH IH P AH IH 
पच्चिस		P AH CH AH  CH IH  S AH 
निस्किन्छ		N IH  S AH  K AH IH N AH  CHA AH 
दिनुसहोस्		DH IH  N UH  S AH HH OH  S AH  
त्यों		TH AH  Y OH  M
त्यहाँ।		TH AH  Y AH HH AA N 
झरालें।		JHA AH R AA  L EH  M
जहाजमा		JH AH HH AA  JH AH M AH AA 
छैनौं।		CHA AH IH  N AH UH  M
चिडियाखाना		CH IH  D AH IH Y AA  KA AH AA N AH AA 
खानुपर्छ		KA AA  N UH  P AH R AH  CHA AH 
क्याशियर		K AH  Y AA  S IH  Y AH R AH 
कृपया एकै छिन।		K AH R P AH Y AA  
किताबहरु		K IH  TH AA  B AH HH AH R UH  
कसिएको		K AH S IH  EH K OH  
कम्प्याक्ट		K AH M AH  P AH  Y AA  K AH  T AH 
एसीमा		EH S IH  M AA  
आशामा		AA S AA  M AH AA 
आर		AA R AH 
आईतबार		AA IH TH AH B AA  R AH 
आँखामा		AAN KA AA  M AH AA 
अहिले कति समय भयो		AH HH IH  L EH  BA AH Y OH  
अमेरिका		AH M EH  R IH  K AA  
अन्त		AH N AH  TH AH 
अचानक		AH CH AA  N AH K AH 
अगस्त		AH G AH S AH  TH AH 
स्वास्थ्य		S AH  W AA  S AH  THA AH  Y AH 
स्पष्ट		S AH  P AH S AH  T AH 
स्नान		S AH  N AA  N AH 
स्कर्ट		S AH  K AH R AH  T AH 
सुटकेश		S UH  T AH K EH  S AH 
विवरण		W IH  W AH R AH N AH 
वर्णन		W AH R AH  N AH N AH 
लन्डन		L AH N AH  D AH N AH 
रेस्टुरेन्टको		R EH  S AH  T UH  R AH EH N AH  T AH K OH  
राख्नुपर्छ		R AA  KA AH  N UH  P AH R AH  CHA AH 
येनमा		Y EH  N AH M AA  
मेनू		M EH  N UH  
मेट्रो		M EH  T AH  R OH  
मूल्यसूचि		M UH  L AH  Y AH S AH UH CH IH  
मिलाइदिनुहोस्।		M IH  L AA  IH DH AH IH N UH  HH OH  S AH  
मिनेटको		M IH  N EH  T AH K OH  
मार्च		M AA  R AH  CH AH 
मदिरा		M AH DH IH  R AA  
भोलीको		BA OH  L IH  K AH OH 
भारी		BA AA  R IH  
ब्यूँझाउने		B AH  Y UH N JHA AA  UH N EH  
बिमाको		B IH  M AA  K OH  
बनाइदिनुहोस्।		B AH N AA  IH DH IH  N UH  HH OH  S AH  
फ्लईट		PA AH  L IH  T AH 
फुटबल		PA UH  T AH B AH L AH 
पिज्जा		P IH  JH AH  JH AA  
पालो		P AA  L OH  
पत्र।		P AH TH AH  R AH 
पट्टी		P AH T AH  T IH  
नौलो		N AH UH  L OH  
निकाल्न		N IH  K AA  L AH  N AH 
नलिनुहोस्््		N AH L IH  N UH  HH OH  S AH    
दैनिक		DH AH IH  N AH IH K AH 
देखी		DH EH  KA IH  
दुबै		DH UH  B AH IH  
दशको		DH AH S AH K OH  
दयाको		DH AH Y AA  K OH  
तिर्नुहोस्।		TH IH  R AH  N UH  HH OH  S AH  
तिमि		TH IH  M AH IH 
तारो		TH AA  R OH  
ड्रायर		D AH  R AA  Y AH R AH 
ड्राफ्ट		D AH  R AA  PA AH  T AH 
डिपार्टमेन्टल		D IH  P AA  R AH  T AH M EH  N AH  T AH L AH 
डाँक		D AA N K AH 
डरलाग्दो		D AH R AH L AA  G AH  DH OH  
टोकन		T OH  K AH N AH 
टिभि		T IH  BA AH IH 
जसो		JH AH S OH  
जसरी		JH AH S AH R IH  
जवान		JH AH W AA  N AH 
छाता		CHA AA  TH AH AA 
चौध		CH AH UH  DHA AH 
चिकित्सकको		CH IH  K AH IH TH AH  S AH K AH K OH  
चल्नुस्		CH AH L AH  N UH  S AH  
घटाउन		GA AH T AA  UH N AH 
गरौं		G AH R AH UH  M
खराबी		KA AH R AA  B IH  
कलर		K AH L AH R AH 
कक्ष		K AH K AH  S AH 
ओहो।		OH HH OH  
ओर्लिन		OH R AH  L IH  N AH 
असी		AH S IH  
अलिकती		AH L IH  K AH TH AH IH 
होईन।		HH OH  IH N AH 
हिल		HH IH  L AH 
स्कूल		S AH  K UH  L AH 
सावर		S AA  W AH R AH 
साटीदिनुहोला।		S AA  T IH  DH AH IH N UH  HH OH  L AH AA 
साटि		S AA  T IH  
समुन्द्र		S AH M UH  N AH  DH AH  R AH 
शल्यक्रिया		S AH L AH  Y AH K AH  R IH  Y AA  
व्याख्या		W AH  Y AA  KA AH  Y AH AA 
विवाहित		W IH  W AA  HH AH IH TH AH 
वटा।		W AH T AA  
लेखिदिनुहुन्छ		L EH  KA IH  DH AH IH N UH  HH AH UH N AH  CHA AH 
लागिरहेको		L AA  G IH  R AH HH EH  K OH  
रोचक		R OH  CH AH K AH 
रिल		R IH  L AH 
रहनुहोस।		R AH HH AH N UH  HH OH  S AH 
युनाइटेड		Y UH  N AA  IH T EH  D AH 
यहीँ		Y AH HH IH N 
यती		Y AH TH IH  
मिल्दैन		M IH  L AH  DH AH AH IH N AH 
मिलाउने		M IH  L AA  UH N EH  
मिलाईदिन		M IH  L AA  IH DH AH IH N AH 
मान्छेको		M AA  N AH  CHA EH  K OH  
भइसक्यो।		BA IH  S AH K AH  Y OH  
ब्ल्यान्केट		B AH  L AH  Y AA  N AH  K EH  T AH 
बोर्ड		B OH  R AH  D AH 
बिर्सें।		B IH  R AH  S EH  M
बस्दैछु।		B AH S AH  DH AH IH  CHA UH  
फ्रान्सिस्को		PA AH  R AA  N AH  S IH  S AH  K OH  
फर्म		PA AH R AH  M AH 
पिडा		P IH  D AA  
पाँचौ		P AA N CH AH UH  
परिवार		P AH R IH  W AA  R AH 
परिकारहरु		P AH R IH  K AA  R AH HH AH R UH  
पञ्चट		P AH N AH  CH AH T AH 
पकाएको		P AH K AA  EH K OH  
नसक्ने		N AH S AH K AH  N EH  
दुईजना		DH UH  IH JH AH N AA  
दिनुपर्छ		DH IH  N UH  P AH R AH  CHA AH 
त्यहिँ		TH AH  Y AH HH IH N 
तिर्नुपर्छ।		TH IH  R AH  N UH  P AH R AH  CHA AH 
तारेको		TH AA  R EH  K OH  
तल्लाको		TH AH L AH  L AA  K OH  
तपाईं के गर्नुहुन्छ		TH AH P AA  IH M
डिग्री		D IH  G AH  R AH IH 
टावर		T AA  W AH R AH 
जापानीहरु		JH AA  P AH AA N IH  HH AH R UH  
छोडेछु।		CHA OH  D EH  CHA UH  
चियर्स।		CH IH  Y AH R AH  S AH 
चिकित्सकलाई		CH IH  K AH IH TH AH  S AH K AH L AA  IH 
चाहनु		CH AA  HH AH N UH  
गल्ति		G AH L AH  TH IH  
गर्छौं		G AH R AH  CHA AH UH  M
गरे।		G AH R EH  
गरिराखेको		G AH R IH  R AA  KA EH  K OH  
खोल		KA OH  L AH 
खासै		KA AA  S AH IH  
खानाहरु		KA AA  N AH AA HH AH R UH  
कोर्न		K OH  R AH  N AH 
के भन्न खोज्नु भएको		K EH  BA AH EH K OH  
कक्षा		K AH K AH  S AA  
एक्स		EH K AH  S AH 
एकचोटि		EH K AH CH OH  T IH  
ई		IH 
आफु		AA PA UH  
आउनेछु।		AA UH N EH  CHA UH  
आउँ		AA UHN 
अमेरिकाको		AH M EH  R IH  K AA  K OH  
अड्डा		AH D AH  D AA  
होटलसम्म		HH OH  T AH L AH S AH M AH  M AH 
हेर्नु		HH EH  R AH  N UH  
हिसाबको		HH IH  S AA  B AH K OH  
हलुका		HH AH L UH  K AA  
सुन्नियो।		S UH  N AH  N IH  Y OH  
समुद्र		S AH M UH  DH AH  R AH 
सजिलैसँग		S AH JH IH  L AH AH IH S AHN G AH 
सके		S AH K EH  
वास्तवमै		W AA  S AH  TH AH W AH M AH IH  
लक्षण		L AH K AH  S AH N AH 
रोक।		R OH  K AH 
मुल्यमा		M UH  L AH  Y AH M AA  
मिलाउनुहोस्।		M IH  L AA  UH N UH  HH OH  S AH  
भुक्तानी		BA UH  K AH  TH AA  N IH  
भात		BA AA  TH AH 
भाडाको		BA AA  D AH AA K OH  
ब्यागेज		B AH  Y AA  G EH  JH AH 
फर्काउन		PA AH R AH  K AA  UH N AH 
प्लेटफर्म		P AH  L EH  T AH PA AH R AH  M AH 
पोष्टकार्ड		P OH  S AH  T AH K AA  R AH  D AH 
पुष्टि		P UH  S AH  T IH  
पकाउन चाहनुहुन्छ		P AH K AA  UH N AH 
धुलाउन		DHA UH  L AA  UH N AH 
दिशामा		DH IH  S AA  M AH AA 
तिर।		TH IH  R AH 
तपाइले		TH AH P AA  IH L EH  
ढोकामा		DA OH  K AA  M AH AA 
डुंगा		D UH  MG AA  
टोपी		T OH  P IH  
टेप		T EH  P AH 
टाउन		T AA  UH N AH 
छौ		CHA AH UH  
छू।		CHA UH  
छुट्टी		CHA UH  T AH  T IH  
चस्मा		CH AH S AH  M AA  
गते		G AH TH EH  
खरिद		KA AH R IH  DH AH 
एलर्जीहरु		EH L AH R AH  JH IH  HH AH R UH  
एकसय		EH K AH S AH Y AH 
एकतर्फी		EH K AH TH AH R AH  PA IH  
उठाउनुहोस्।		UH TA AA  UH N UH  HH OH  S AH  
आमाको		AA M AA  K OH  
आपत्काल		AA P AH TH AH  K AA  L AH 
आउँनसक्छु		AA UHN N AH S AH K AH  CHA UH  
असर		AH S AH R AH 
अप		AH P AH 
हैन।		HH AH IH  N AH 
हालेर		HH AA  L EH  R AH 
हार		HH AA  R AH 
हातमा		HH AA  TH AH M AH AA 
हवाईमेलबाट		HH AH W AA  IH M EH  L AH B AH AA T AH 
स्पेशल		S AH  P EH  S AH L AH 
स्टेशनको		S AH  T EH  S AH N AH K OH  
स्टाइल		S AH  T AA  IH L AH 
सहयोगको		S AH HH AH Y OH  G AH K AH OH 
सधै		S AH DHA AH IH  
शुभकामनाहरु।		S UH  BA AH K AA  M AH N AH AA HH AH R AH UH 
विधार्थी		W IH  DHA AA  R AH  THA AH IH 
वाकवाक		W AA  K AH W AH AA K AH 
ल्याइदिन		L AH  Y AA  IH DH IH  N AH 
लुगाधुने		L UH  G AA  DHA AH UH N EH  
ला।		L AA  
लाग्नेछ।		L AA  G AH  N EH  CHA AH 
लगाउँ		L AH G AA  UHN 
रोकडमा		R OH  K AH D AH M AA  
यो।		Y OH  
यिनीहरुलाई		Y IH  N AH IH HH AH R UH  L AA  IH 
मनाही		M AH N AA  HH IH  
भईरहेको		BA IH  R AH HH EH  K OH  
बेहोस		B EH  HH OH  S AH 
बुकिंग		B UH  K IH  MG AH 
बताइदिनुहुन्छ		B AH TH AA  IH DH IH  N UH  HH AH UH N AH  CHA AH 
प्रकारका		P AH  R AH K AA  R AH K AH AA 
पेरिस		P EH  R IH  S AH 
पार्ने		P AA  R AH  N EH  
पाउन्ड		P AA  UH N AH  D AH 
पर्मानेन्ट		P AH R AH  M AA  N EH  N AH  T AH 
पर्दा		P AH R AH  DH AA  
पट्टि		P AH T AH  T IH  
निस्किने		N IH  S AH  K AH IH N EH  
निर		N IH  R AH 
दिनसक्छु		DH IH  N AH S AH K AH  CHA UH  
थुप्रै		THA UH  P AH  R AH IH  
थिए		THA IH  EH 
तौलिया		TH AH UH  L IH  Y AA  
डेल्टा		D EH  L AH  T AA  
टिम		T IH  M AH 
टिकट।		T IH  K AH T AH 
जोरो		JH OH  R AH OH 
जिन्स		JH IH  N AH  S AH 
चौबीस		CH AH UH  B IH  S AH 
ग्रान्ड		G AH  R AA  N AH  D AH 
गर्नुहुन्न		G AH R AH  N UH  HH AH UH N AH  N AH 
गर्नका		G AH R AH  N AH K AA  
गर्दैनौं।		G AH R AH  DH AH IH  N AH UH  M
क्यासिनो		K AH  Y AA  S IH  N OH  
कुर्नु		K UH  R AH  N AH UH 
कामदार।		K AA  M AH DH AH AA R AH 
कहाँको		K AH HH AA N K OH  
उहाँहरू		UH HH AA N HH AH R UH  
उजुरी		UH JH UH  R IH  
इकोनोमी		IH K OH  N AH OH M IH  
आउला		AA UH L AA  
अफिसर।		AH PA IH  S AH R AH 
हेर्नुहोस्		HH EH  R AH  N UH  HH OH  S AH  
हिंड्न		HH IH  MD AH  N AH 
हाल्ने		HH AA  L AH  N EH  
हप्तामा		HH AH P AH  TH AA  M AH AA 
सोचेको		S OH  CH EH  K AH OH 
सुपरमार्केट		S UH  P AH R AH M AA  R AH  K EH  T AH 
सीधै		S IH  DHA AH AH IH 
साथमा		S AA  THA AH M AH AA 
साट्नुहोस्।		S AA  T AH  N UH  HH OH  S AH  
सागुँरो		S AA  G UH N R OH  
सकेको		S AH K EH  K OH  
शुभनाम		S UH  BA AH N AA  M AH 
शिकागोको		S IH  K AA  G OH  K AH OH 
शर्ट		S AH R AH  T AH 
व्यापारिक		W AH  Y AA  P AH AA R IH  K AH 
वरपर		W AH R AH P AH R AH 
लोकप्रीय		L OH  K AH P AH  R IH  Y AH 
लुटियो।		L UH  T IH  Y OH  
रेलको		R EH  L AH K OH  
रगतटाइप		R AH G AH TH AH T AA  IH P AH 
रंगिन		R AH MG IH  N AH 
रंगहरुमा		R AH MG AH HH AH R UH  M AA  
यसरी		Y AH S AH R IH  
मोड्मा		M OH  D AH  M AA  
मार्गबाट।		M AA  R AH  G AH B AH AA T AH 
ब्यबस्था		B AH  Y AH B AH S AH  THA AA  
बोर्डिङ्ग		B OH  R AH  D IH  NG AH  G AH 
बेल		B EH  L AH 
बेरिदिनुहोस्।		B EH  R IH  DH AH IH N UH  HH OH  S AH  
बिसौनीमा		B IH  S AH UH  N AH IH M AA  
बस।		B AH S AH 
बदल्नसक्छु		B AH DH AH L AH  N AH S AH K AH  CHA UH  
प्लाजा		P AH  L AA  JH AH AA 
पुगेपछि		P UH  G EH  P AH CHA IH  
पार्किङ		P AA  R AH  K IH  NG AH 
पारि		P AA  R IH  
पर्न		P AH R AH  N AH 
धेरैजसो		DHA EH  R AH IH  JH AH S OH  
द्वार		DH AH  W AA  R AH 
दाबी		DH AA  B IH  
दशवटा		DH AH S AH W AH T AA  
तीन।		TH IH  N AH 
तयारी		TH AH Y AA  R IH  
तपाईं अण्डा कसरी		TH AH P AA  IH M
तथा		TH AH THA AA  
ढुवानी		DA UH  W AA  N IH  
डाक्टरले		D AA  K AH  T AH R AH L EH  
टेलिभिजन		T EH  L IH  BA AH IH JH AH N AH 
टाँक		T AA N K AH 
टर्च		T AH R AH  CH AH 
जापानीमा		JH AA  P AH AA N IH  M AH AA 
जहिले		JH AH HH IH  L EH  
चिन्तित		CH IH  N AH  TH AH IH TH AH 
गिंलास		G IH  ML AA  S AH 
गर्दैन।		G AH R AH  DH AH IH  N AH 
कि।		K IH  
कारणले		K AA  R AH N AH L EH  
काटेर		K AA  T EH  R AH 
कफी।		K AH PA IH  
उनीहरु		UH N IH  HH AH R UH  
इटालियन		IH T AA  L IH  Y AH N AH 
आकास्मिक		AA K AA  S AH  M IH  K AH 
आकर्षक		AA K AH R AH  S AH K AH 
हेर्दा		HH EH  R AH  DH AA  
हेरिदिनुहोस्।		HH EH  R IH  DH AH IH N UH  HH OH  S AH  
स्वादिष्ट		S AH  W AA  DH IH  S AH  T AH 
स्मिस		S AH  M IH  S AH 
सेल		S EH  L AH 
सुहाउँछ		S UH  HH AA  UHN CHA AH 
सुविधा		S UH  W IH  DHA AA  
सुरक्षा		S UH  R AH K AH  S AA  
सुपर		S UH  P AH R AH 
सामानहरू		S AA  M AH AA N AH HH AH R UH  
सात।		S AA  TH AH 
सर्वीस		S AH R AH  W IH  S AH 
सबैलाई		S AH B AH IH  L AA  IH 
शुद्ध		S UH  DH AH  DHA AH 
विषय		W IH  S AH Y AH 
लिई		L IH  IH 
लागिकोसेली		L AA  G IH  K OH  S EH  L AH IH 
रोस्ट		R OH  S AH  T AH 
रोग		R OH  G AH 
मुल्यवान		M UH  L AH  Y AH W AA  N AH 
मिलाइदिनु		M IH  L AA  IH DH AH IH N UH  
मसित		M AH S IH  TH AH 
मर्कियो।		M AH R AH  K IH  Y OH  
भीड		BA IH  D AH 
भावनाको		BA AA  W AH N AH AA K OH  
भाँचिएको		BA AA N CH IH  EH K OH  
बित्तिकै		B IH  TH AH  TH AH IH K AH AH IH 
बाथरुम		B AA  THA AH R UH  M AH 
बदल्न		B AH DH AH L AH  N AH 
बताउन		B AH TH AA  UH N AH 
फुल		PA UH  L AH 
फिल्मको		PA IH  L AH  M AH K OH  
फर्किन्छु।		PA AH R AH  K IH  N AH  CHA UH  
प्राथमिक		P AH  R AA  THA AH M IH  K AH 
पुष्टिकरण		P UH  S AH  T IH  K AH R AH N AH 
पुग्नु		P UH  G AH  N AH UH 
पीडा		P IH  D AA  
पिएको		P IH  EH K OH  
पि		P IH  
परेकोमा		P AH R EH  K OH  M AA  
परें।		P AH R EH  M
पठाएको		P AH TA AA  EH K OH  
निर्माण		N IH  R AH  M AA  N AH 
नापको		N AA  P AH K OH  
नाटक कति बेला सुरू हुन्छ		N AA  T AH K AH S UH  R AH UH 
नाच्न		N AA  CH AH  N AH 
नलगाउनूहोस।		N AH L AH G AA  UH N UH  HH OH  S AH 
नदुख्ने		N AH DH UH  KA AH  N EH  
नगरिदिनुहोला।		N AH G AH R IH  DH AH IH N UH  HH OH  L AA  
धूम्रपान		DHA UH  M AH  R AH P AA  N AH 
द्वारा।		DH AH  W AA  R AH AA 
दिनुभयो।		DH IH  N UH  BA AH Y OH  
तल्लो		TH AH L AH  L OH  
तपाईंकहाँ		TH AH P AA  IH MK AH HH AH AAN 
जी।		JH IH  
जाल		JH AA  L AH 
चर्च		CH AH R AH  CH AH 
गर्नलाई		G AH R AH  N AH L AA  IH 
गर्दैछौँ।		G AH R AH  DH AH IH  CHA AH UH N 
खुसि		KA UH  S IH  
क्षमा		K AH  S AH M AA  
कोठाहरू		K OH  TA AA  HH AH R UH  
कोकाकोला		K OH  K AA  K AH OH L AH AA 
कुनबाटो		K UH  N AH B AA  T OH  
काँहा		K AA N HH AH AA 
कर्मचारी		K AH R AH  M AH CH AA  R IH  
करीब		K AH R IH  B AH 
कम्तिमा		K AH M AH  TH IH  M AA  
ऐतिहासिक		IH  TH AH IH HH AA  S AH IH K AH 
अखबारहरु		AH KA AH B AA  R AH HH AH R UH  
होटेलसम्म		HH OH  T EH  L AH S AH M AH  M AH 
हेर्दैछु		HH EH  R AH  DH AH IH  CHA UH  
हुनहुन्छ		HH UH  N AH HH AH UH N AH  CHA AH 
हस।		HH AH S AH 
सित्तैमा		S IH  TH AH  TH AH AH IH M AA  
सान्		S AA  N AH  
सातको		S AA  TH AH K OH  
सक्यो		S AH K AH  Y OH  
संधै		S AH MDHA AH IH  
शाखा		S AA  KA AH AA 
व्यक्तिलाई		W AH  Y AH K AH  TH IH  L AA  IH 
वजन		W AH JH AH N AH 
लिनको		L IH  N AH K OH  
रोकिन्छौं		R OH  K IH  N AH  CHA AH UH  M
रेयरमा		R EH  Y AH R AH M AA  
रजिस्टर		R AH JH IH  S AH  T AH R AH 
रक्सीको		R AH K AH  S IH  K OH  
योकोठा		Y OH  K AH OH TA AA  
येसकोबारे		Y EH  S AH K OH  B AA  R AH EH 
यू		Y UH  
यहीं		Y AH HH IH  M
मसंग		M AH S AH MG AH 
मनपर्यो।		M AH N AH P AH R AH  Y OH  
भनिदिन		BA AH N IH  DH AH IH N AH 
भंसार		BA AH MS AA  R AH 
बोलाउनु		B OH  L AA  UH N UH  
बोलाईदिन		B OH  L AA  IH DH IH  N AH 
बैंकमा		B AH IH  MK AH M AA  
बिर्सिएँ।		B IH  R AH  S AH IH EHN 
बहिरहन्छ।		B AH HH IH  R AH HH AH N AH  CHA AH 
फुर्सद		PA UH  R AH  S AH DH AH 
फुर्सत		PA UH  R AH  S AH TH AH 
फुकाल्नुहोस्।		PA UH  K AA  L AH  N AH UH HH OH  S AH  
पोका		P OH  K AA  
पैसामा		P AH IH  S AA  M AH AA 
पैंतीस		P AH IH  MTH AH IH S AH 
पानीजहाज		P AA  N IH  JH AH HH AH AA JH AH 
पाँचमा		P AA N CH AH M AH AA 
पलंग		P AH L AH MG AH 
पर्यटन		P AH R AH  Y AH T AH N AH 
पर्खन		P AH R AH  KA AH N AH 
पत्रिकहरू		P AH TH AH  R IH  K AH HH AH R UH  
पत्थर		P AH TH AH  THA AH R AH 
नहुने		N AH HH UH  N EH  
नजीकैको		N AH JH IH  K AH AH IH K OH  
दूध		DH UH  DHA AH 
थकित		THA AH K IH  TH AH 
तिर्खा		TH IH  R AH  KA AA  
तिरिसकें।		TH IH  R AH IH S AH K EH  M
तरिकाले		TH AH R IH  K AA  L EH  
तपाईंका		TH AH P AA  IH MK AH AA 
तपाइको		TH AH P AA  IH K OH  
डेस्क		D EH  S AH  K AH 
ठिक्कको		TA IH  K AH  K AH K OH  
ठाऊँमा		TA AA  UHN M AH AA 
जवाफ		JH AH W AA  PA AH 
छत्तिस		CHA AH TH AH  TH IH  S AH 
चाही		CH AA  HH IH  
चढाइदिनुहोला।		CH AH DA AA  IH DH IH  N UH  HH OH  L AH AA 
घण्टा।		GA AH N AH  T AA  
खुशीको		KA UH  S IH  K OH  
खली		KA AH L IH  
क्षमाप्रार्थी		K AH  S AH M AA  P AH  R AH AA R AH  THA IH  
कार्ड।		K AA  R AH  D AH 
कार्डहरु		K AA  R AH  D AH HH AH R UH  
कहिलेदेखि		K AH HH IH  L EH  DH AH EH KA AH IH 
कफि		K AH PA IH  
एफ		EH PA AH 
एकमा		EH K AH M AA  
उसिनेको		UH S IH  N EH  K OH  
उपयुक्त		UH P AH Y UH  K AH  TH AH 
इन्च		IH N AH  CH AH 
इचिरो		IH CH IH  R OH  
आफ्ना		AA PA AH  N AA  
आउँदैछ।		AA UHN DH AH IH  CHA AH 
आईपुग्छौं		AA IH P UH  G AH  CHA AH AH UH M
आइल		AA IH L AH 
अगाडी।		AH G AA  D IH  
हे		HH EH  
हाम्रा		HH AA  M AH  R AH AA 
हामीसँगै		HH AA  M IH  S AHN G AH AH IH 
हामि		HH AA  M IH  
हाते		HH AA  TH EH  
हरू		HH AH R UH  
स्मारिका		S AH  M AA  R IH  K AH AA 
स्क्वेर		S AH  K AH  W EH  R AH 
सोच्ने		S OH  CH AH  N EH  
सोख		S OH  KA AH 
सो		S OH  
सेफ्टी		S EH  PA AH  T IH  
सेक्नुहोस।		S EH  K AH  N UH  HH OH  S AH 
सुन्नुहोस्		S UH  N AH  N AH UH HH OH  S AH  
सिंगान		S IH  MG AA  N AH 
साठी		S AA  TA IH  
सर्		S AH R AH  
समातेर		S AH M AA  TH EH  R AH 
सबवेको		S AH B AH W EH  K OH  
सटहि		S AH T AH HH IH  
शाखामा		S AA  KA AH AA M AH AA 
लिपस्टिक		L IH  P AH S AH  T AH IH K AH 
लिउँ		L AH IWN 
रेलबाट		R EH  L AH B AA  T AH 
राख्दिन		R AA  KA AH  DH IH  N AH 
रमाउँछु।		R AH M AA  UHN CHA UH  
म्		M AH  
मिठाई		M IH  TA AA  IH 
मार्गको		M AA  R AH  G AH K OH  
महंगो		M AH HH AH MG OH  
मसालेदार		M AH S AA  L EH  DH AH AA R AH 
भनिन्छ।		BA AH N IH  N AH  CHA AH 
बोल्दिन।		B OH  L AH  DH IH  N AH 
बेर्नसक्नुहुन्छ		B EH  R AH  N AH S AH K AH  N UH  HH AH UH N AH  CHA AH 
बाथरूम		B AA  THA AH R UH  M AH 
बनाई		B AH N AA  IH 
पाहिले		P AA  HH IH  L EH  
पाकेको		P AA  K EH  K OH  
पाए		P AA  EH 
पाँच।		P AA N CH AH 
पर्ची		P AH R AH  CH IH  
पर्खिदिनुहुन्छ		P AH R AH  KA IH  DH AH IH N UH  HH AH UH N AH  CHA AH 
पंग्चर		P AH MG AH  CH AH R AH 
नीलो		N IH  L OH  
निस्कन		N IH  S AH  K AH N AH 
नक्कली		N AH K AH  K AH L IH  
दुइवटा		DH UH  IH W AH T AA  
दिनुभयो		DH IH  N UH  BA AH Y OH  
दश्तखत		DH AH S AH  TH AH KA AH TH AH 
थाहाछैन।		THA AA  HH AH AA CHA AH IH  N AH 
थप्नुहोस्।		THA AH P AH  N UH  HH OH  S AH  
तिनी		TH IH  N AH IH 
तला		TH AH L AA  
तर्फबाट		TH AH R AH  PA AH B AA  T AH 
ठोक्काएँ।		TA OH  K AH  K AA  EHN 
टानका		T AA  N AH K AH AA 
झ्यालपट्टिको		JHA AH  Y AA  L AH P AH T AH  T IH  K OH  
झोलाको		JHA OH  L AA  K AH OH 
जो		JH OH  
जिन		JH IH  N AH 
जाना		JH AA  N AH AA 
जहाजबाट		JH AH HH AA  JH AH B AH AA T AH 
छोरी		CHA OH  R IH  
गिलासमा		G IH  L AA  S AH M AH AA 
गरें		G AH R EH  M
खेल्नुहुन्छ		KA EH  L AH  N UH  HH AH UH N AH  CHA AH 
खेलको		KA EH  L AH K OH  
खाटमा		KA AA  T AH M AH AA 
कोशिश		K OH  S IH  S AH 
केही।		K EH  HH IH  
कृपया एकै छिन पर्खनसक्नुहुन्छ		K AH R P AH Y AA  P AH R AH  KA AH N AH S AH K AH  N UH  HH AH UH N AH  CHA AH 
की।		K IH  
कार्टुन		K AA  R AH  T UH  N AH 
काट्ने		K AA  T AH  N EH  
काटियो।		K AA  T IH  Y OH  
कसिलो		K AH S IH  L OH  
एयरलाइन्सको		EH Y AH R AH L AA  IH N AH  S AH K OH  
एक।		EH K AH 
उनले		UH N AH L EH  
उज्यालो		UH JH AH  Y AA  L OH  
इन्जिन		IH N AH  JH IH  N AH 
आन्जलस		AA N AH  JH AH L AH S AH 
आधुनिक		AA DHA UH  N IH  K AH 
आजरातिको		AA JH AH R AA  TH IH  K OH  
आइस		AA IH S AH 
आइतवार		AA IH TH AH W AA  R AH 
अवस्था		AH W AH S AH  THA AA  
अध्यागमन		AH DHA AH  Y AA  G AH M AH N AH 
अघिल्लो		AH GA IH  L AH  L OH  
सोह्र		S OH  HH AH  R AH 
सोहो		S OH  HH AH OH 
सुजुकि		S UH  JH AH UH K IH  
सार्वजानिक		S AA  R AH  W AH JH AH AA N IH  K AH 
साइट्सिइङ्ग		S AA  IH T AH  S IH  IH NG AH  G AH 
सफ्ट		S AH PA AH  T AH 
सङ्गीत		S AH NG AH  G IH  TH AH 
शोख		S OH  KA AH 
व्यवसाय		W AH  Y AH W AH S AA  Y AH 
विमानस्थलको		W IH  M AA  N AH S AH  THA AH L AH K OH  
वास्ता		W AA  S AH  TH AH AA 
लोशन		L OH  S AH N AH 
लेबुल		L EH  B UH  L AH 
लागेको।		L AA  G EH  K OH  
लबीमा		L AH B IH  M AA  
रेलहरु		R EH  L AH HH AH R UH  
राजदूतावास		R AA  JH AH DH UH  TH AH AA W AH AA S AH 
रख्नुहोस्।		R AH KA AH  N UH  HH OH  S AH  
येन।		Y EH  N AH 
यहाँँबाट		Y AH HH AA N N B AH AA T AH 
मिडियम		M IH  D AH IH Y AH M AH 
महिनामा		M AH HH IH  N AA  M AH AA 
महत्वपूर्ण		M AH HH AH TH AH  W AH P UH  R AH  N AH 
मर्काएँ।		M AH R AH  K AA  EHN 
भेतेर		BA EH  TH AH EH R AH 
भित्रै		BA IH  TH AH  R AH AH IH 
भएमा		BA EH  M AA  
बैंकको		B AH IH  MK AH K OH  
बेलुकी		B EH  L UH  K IH  
बिषयमा		B IH  S AH Y AH M AA  
बाथ		B AA  THA AH 
बजिरहेको		B AH JH IH  R AH HH EH  K OH  
फुट्ने		PA UH  T AH  N EH  
फर्किन्छ		PA AH R AH  K IH  N AH  CHA AH 
पीडित		P IH  D AH IH TH AH 
पारिदिनुहोस्।		P AA  R IH  DH AH IH N UH  HH OH  S AH  
पांच		P AA  MCH AH 
पर्खनु		P AH R AH  KA AH N UH  
पठाई		P AH TA AA  IH 
पचहत्तर		P AH CH AH HH AH TH AH  TH AH R AH 
निर्देशन		N IH  R AH  DH EH  S AH N AH 
नङ		N AH NG AH 
धुनुपर्ने		DHA UH  N AH UH P AH R AH  N EH  
देखाउने		DH EH  KA AA  UH N AH EH 
दिनुहोला		DH IH  N UH  HH OH  L AA  
ताल		TH AA  L AH 
तरकारी		TH AH R AH K AA  R IH  
डाइनिङ्ग		D AA  IH N IH  NG AH  G AH 
ट्वीन		T AH  W IH  N AH 
टोक्यो		T OH  K AH  Y AH OH 
टोकनको		T OH  K AH N AH K AH OH 
टूरमा		T UH  R AH M AA  
टिभी		T IH  BA AH IH 
झिक्न		JHA IH  K AH  N AH 
झालपट्टि		JHA AA  L AH P AH T AH  T IH  
जापानसम्म		JH AA  P AH AA N AH S AH M AH  M AH 
जाँचको		JH AA N CH AH K OH  
छुट्ने		CHA UH  T AH  N EH  
छुट्छ।		CHA UH  T AH  CHA AH 
छीटो		CHA IH  T OH  
चढ्नुहोस्।		CH AH DA AH  N UH  HH OH  S AH  
चकलेट		CH AH K AH L EH  T AH 
गर्दिनुहोस्।		G AH R AH  DH IH  N UH  HH OH  S AH  
ख्याल		KA AH  Y AA  L AH 
क्षमता		K AH  S AH M AH TH AA  
क्षतिपूर्ति		K AH  S AH TH IH  P UH  R AH  TH AH IH 
कुरा।		K UH  R AA  
कलाकार		K AH L AA  K AH AA R AH 
कम्		K AH M AH  
कपालमा		K AH P AA  L AH M AH AA 
कटाउन		K AH T AA  UH N AH 
औषधिहरु		AH UN S AH DHA IH  HH AH R UH  
औँला		AH UNN L AA  
एउटाको		EW T AA  K OH  
उमेर		UH M EH  R AH 
उपकरण		UH P AH K AH R AH N AH 
उन्नाइस		UH N AH  N AA  IH S AH 
उनीहरुले		UH N IH  HH AH R UH  L EH  
आसपास		AA S AH P AA  S AH 
आमा		AA M AA  
आउदैन।		AA UH DH AH IH  N AH 
आईपुग्छु।		AA IH P UH  G AH  CHA AH UH 
अफिसमा		AH PA IH  S AH M AA  
ह्वाइट		HH AH  W AA  IH T AH 
होटलबाट		HH OH  T AH L AH B AA  T AH 
हुनुभएको		HH UH  N AH UH BA EH  K OH  
हुँदैछ		HH UH N DH AH IH  CHA AH 
हुँदा		HH UH N DH AA  
हाल्नुहोस्।		HH AA  L AH  N UH  HH OH  S AH  
हामीसंग		HH AA  M IH  S AH MG AH 
सेप्टेम्बर		S EH  P AH  T AH EH M AH  B AH R AH 
सुत्नै		S UH  TH AH  N AH IH  
सकिएको		S AH K IH  EH K OH  
शायद		S AA  Y AH DH AH 
ल्यादिनुहोस्।		L AH  Y AA  DH IH  N UH  HH OH  S AH  
लुगाको		L UH  G AA  K OH  
लाग्दो		L AA  G AH  DH OH  
रोकिंदैन।		R OH  K IH  MDH AH AH IH N AH 
रूपमा		R UH  P AH M AA  
रुपैया		R UH  P AH IH  Y AA  
राखुँ		R AA  KA UH N 
राखी		R AA  KA IH  
राकेट		R AA  K EH  T AH 
मिनेटमा।		M IH  N EH  T AH M AA  
मिटरभन्दा		M IH  T AH R AH BA AH N AH  DH AA  
मार्ने		M AA  R AH  N EH  
मार्केट		M AA  R AH  K EH  T AH 
मानिसहरु		M AA  N IH  S AH HH AH R UH  
मानिस		M AA  N IH  S AH 
महोदय		M AH HH OH  DH AH Y AH 
भेटौला।		BA EH  T AH UH  L AA  
भाँचे।		BA AA N CH EH  
भए।		BA EH  
ब्रोडवे		B AH  R OH  D AH W EH  
बोलाउनुभएको		B OH  L AA  UH N UH  BA EH  K AH OH 
बिलको		B IH  L AH K OH  
बिदेशी		B IH  DH EH  S AH IH 
बिक्रीमा		B IH  K AH  R AH IH M AA  
बहुमूल्य		B AH HH UH  M AH UH L AH  Y AH 
बसाई		B AH S AA  IH 
बराबर		B AH R AA  B AH R AH 
बटर		B AH T AH R AH 
फराकिलो		PA AH R AA  K IH  L OH  
प्रिन्ट		P AH  R IH  N AH  T AH 
पेट्रोलको		P EH  T AH  R OH  L AH K AH OH 
पानीमा		P AA  N IH  M AH AA 
पाउँ		P AA  UHN 
पर्खँदैछु।		P AH R AH  KA AHN DH AH IH  CHA UH  
पट्टिको		P AH T AH  T IH  K OH  
पछि।		P AH CHA IH  
निस्किन्छु।		N IH  S AH  K AH IH N AH  CHA UH  
नगर		N AH G AH R AH 
देखिएको		DH EH  KA IH  EH K OH  
देखाउँछु।		DH EH  KA AA  UHN CHA UH  
थिईन।		THA IH  IH N AH 
थकाइ		THA AH K AA  IH 
त्यहाँबाट		TH AH  Y AH HH AA N B AH AA T AH 
तेह्र		TH EH  HH AH  R AH 
तीर		TH IH  R AH 
ढीलो		DA IH  L OH  
ट्रान्जिट		T AH  R AA  N AH  JH IH  T AH 
ज्याज		JH AH  Y AA  JH AH 
जाँच्नुहोला।		JH AA N CH AH  N UH  HH OH  L AH AA 
जन्मदिन		JH AH N AH  M AH DH IH  N AH 
जकेट		JH AH K EH  T AH 
छोडे		CHA OH  D EH  
छै		CHA AH IH  
चोर		CH OH  R AH 
चाहन्न।		CH AA  HH AH N AH  N AH 
घामले		GA AA  M AH L EH  
घटाउनु		GA AH T AA  UH N UH  
गीत		G IH  TH AH 
गलती		G AH L AH TH IH  
गरिन्छ		G AH R IH  N AH  CHA AH 
गरिदिन्छु।		G AH R IH  DH AH IH N AH  CHA UH  
गएँ।		G EH N 
खेलहरु		KA EH  L AH HH AH R UH  
किन्नु		K IH  N AH  N UH  
किने		K IH  N EH  
कार्य		K AA  R AH  Y AH 
कारहरु		K AA  R AH HH AH R UH  
कारमा		K AA  R AH M AH AA 
काट्नुहोस्		K AA  T AH  N UH  HH OH  S AH  
काटेको		K AA  T EH  K OH  
कागजको		K AA  G AH JH AH K OH  
कक्टेल		K AH K AH  T EH  L AH 
औँठी		AH UNN TA IH  
ओसाका		OH S AA  K AH AA 
उडिन्छ		UH D IH  N AH  CHA AH 
उठाउन		UH TA AA  UH N AH 
आँखाको		AAN KA AA  K OH  
अभिनेता		AH BA IH  N EH  TH AA  
अनुमान		AH N UH  M AA  N AH 
अक्टोबर		AH K AH  T OH  B AH R AH 
हुनुहोस्।		HH UH  N AH UH HH OH  S AH  
स्वेटर		S AH  W EH  T AH R AH 
स्थान		S AH  THA AA  N AH 
स्थलमा		S AH  THA AH L AH M AA  
स्ट्रिटमा		S AH  T AH  R IH  T AH M AA  
सुहाउने		S UH  HH AA  UH N EH  
सामाग्री		S AA  M AH AA G AH  R IH  
सम्झिन		S AH M AH  JHA IH  N AH 
शुभकामना		S UH  BA AH K AA  M AH N AH AA 
विस्तारै		W IH  S AH  TH AA  R AH AH IH 
वाल		W AA  L AH 
ल्याउँ		L AH  Y AA  UHN 
ल्याइदुनुस्		L AH  Y AA  IH DH UH  N AH UH S AH  
लिनुपर्छ।		L IH  N UH  P AH R AH  CHA AH 
लाइनको		L AA  IH N AH K OH  
रसीद।		R AH S IH  DH AH 
रङ्ग		R AH NG AH  G AH 
यात्रुहरु		Y AA  TH AH  R UH  HH AH R AH UH 
यहाँँ		Y AH HH AA N N 
म्यारी		M AH  Y AA  R IH  
म्यानेजर		M AH  Y AA  N EH  JH AH R AH 
मोड्नुस्		M OH  D AH  N UH  S AH  
मेसिन		M EH  S IH  N AH 
माइल		M AA  IH L AH 
मरिच		M AH R IH  CH AH 
भिड		BA IH  D AH 
भरेको		BA AH R EH  K OH  
ब्लाउज		B AH  L AA  UH JH AH 
ब्राउन		B AH  R AA  UH N AH 
ब्यूझाउने		B AH  Y UH  JHA AA  UH N EH  
ब्यागहरु		B AH  Y AA  G AH HH AH R UH  
बोटल		B OH  T AH L AH 
बेरमा		B EH  R AH M AA  
बुझ्नुभयो		B UH  JHA AH  N AH UH BA AH Y OH  
बिषय		B IH  S AH Y AH 
बिमानस्थलमा		B IH  M AA  N AH S AH  THA AH L AH M AH AA 
बित्यो।		B IH  TH AH  Y OH  
बस्नसक्छु		B AH S AH  N AH S AH K AH  CHA UH  
बयान		B AH Y AA  N AH 
बन्ध		B AH N AH  DHA AH 
बदल्ने		B AH DH AH L AH  N EH  
बक्शीश		B AH K AH  S IH  S AH 
फोनहरु		PA OH  N AH HH AH R UH  
फर्कनुहुन्छ		PA AH R AH  K AH N UH  HH AH UH N AH  CHA AH 
फर्कन		PA AH R AH  K AH N AH 
पुतली		P UH  TH AH L IH  
पासपोर्ट।		P AA  S AH P OH  R AH  T AH 
पालिस		P AA  L IH  S AH 
पार्कको		P AA  R AH  K AH K OH  
पाकेट		P AA  K EH  T AH 
पल्ट		P AH L AH  T AH 
पर्चा		P AH R AH  CH AA  
परेन।		P AH R EH  N AH 
निजीका		N IH  JH AH IH K AA  
नापमा		N AA  P AH M AH AA 
देखाउनुस्।		DH EH  KA AA  UH N UH  S AH  
दिनुस्		DH IH  N UH  S AH  
दश्		DH AH S AH  
तोकिएको		TH OH  K IH  EH K AH OH 
तेइस		TH AH EY S AH 
ढोकाको		DA OH  K AA  K AH OH 
डलरका		D AH L AH R AH K AA  
ठाँऊ		TA AA N UH 
ट्राभलरस्		T AH  R AA  BA AH L AH R AH S AH  
टोक्योको		T OH  K AH  Y AH OH K AH OH 
टब		T AH B AH 
जोड्न		JH OH  D AH  N AH 
छाती		CHA AA  TH IH  
चौथो		CH AH UH  THA OH  
चौकी		CH AH UH  K IH  
चेकको		CH EH  K AH K OH  
चुरोटहरू		CH UH  R OH  T AH HH AH R AH UH 
चुरोटको		CH UH  R OH  T AH K AH OH 
गार्हो		G AA  R AH  HH OH  
गल्ली		G AH L AH  L IH  
गर्नेछौं।		G AH R AH  N EH  CHA AH UH  M
गर्नसक्नु		G AH R AH  N AH S AH K AH  N UH  
गराईपाउँछु		G AH R AA  IH P AH AA UHN CHA UH  
खेल्नको		KA EH  L AH  N AH K OH  
खाएर		KA AA  EH R AH 
खाँदै		KA AA N DH AH IH  
कुरामा		K UH  R AA  M AH AA 
काट्।		K AA  T AH  
ओर्लिनुपर्छ		OH R AH  L IH  N UH  P AH R AH  CHA AH 
ओनो		OH N OH  
ऐना		IH  N AA  
एयरलाइन्स		EH Y AH R AH L AA  IH N AH  S AH 
एक्सटेन्सन		EH K AH  S AH T EH  N AH  S AH N AH 
एअर		EH AH R AH 
उम्लेको		UH M AH  L EH  K OH  
उनीले		UH N IH  L EH  
आरामदायी		AA R AA  M AH DH AH AA Y IH  
आकिको		AA K IH  K OH  
अवतरण		AH W AH TH AH R AH N AH 
अप्रिल		AH P AH  R IH  L AH 
अटोम्याटिक		AH T OH  M AH  Y AA  T IH  K AH 
अङ्ग्रेजी		AH NG AH  G AH  R EH  JH IH  
अगाडीको		AH G AA  D IH  K OH  
।		
हेर्नको		HH EH  R AH  N AH K OH  
हेरिदिनुहुन्छ		HH EH  R IH  DH AH IH N UH  HH AH UH N AH  CHA AH 
हुनेछु।		HH UH  N EH  CHA AH UH 
हुनुहन्छ		HH UH  N AH UH HH AH N AH  CHA AH 
हामीहरुलाई		HH AA  M IH  HH AH R UH  L AH AA IH 
हवाईमेलद्वारा		HH AH W AA  IH M EH  L AH DH AH  W AH AA R AH AA 
सुन्ना		S UH  N AH  N AA  
सितैमा		S IH  TH AH AH IH M AA  
साटिदिनुहोस्		S AA  T IH  DH AH IH N UH  HH OH  S AH  
समावेस		S AH M AA  W EH  S AH 
सबेरै		S AH B EH  R AH IH  
सबवेबाट		S AH B AH W EH  B AA  T AH 
सपिङ		S AH P IH  NG AH 
शानदार		S AA  N AH DH AH AA R AH 
ल्याउ		L AH  Y AA  UH 
लाइसेन्स		L AA  IH S EH  N AH  S AH 
रेडियो		R EH  D IH  Y OH  
रहनुहुन्छ		R AH HH AH N UH  HH AH UH N AH  CHA AH 
युवा		Y UH  W AA  
यात्री		Y AA  TH AH  R IH  
मौका		M AH UH  K AA  
मिल्क		M IH  L AH  K AH 
मा।		M AA  
मार्न		M AA  R AH  N AH 
माथी		M AA  THA IH  
भिन्दै		BA IH  N AH  DH AH AH IH 
भरिएको		BA AH R IH  EH K OH  
भरपर्दो		BA AH R AH P AH R AH  DH OH  
बिहिबार		B IH  HH AH IH B AA  R AH 
बच्चाहरुको		B AH CH AH  CH AA  HH AH R UH  K OH  
बचत		B AH CH AH TH AH 
बग्दैन।		B AH G AH  DH AH IH  N AH 
फेर्नु		PA EH  R AH  N UH  
फलफुल		PA AH L AH PA UH  L AH 
प्राप्त		P AH  R AA  P AH  TH AH 
प्रवेशद्वार		P AH  R AH W EH  S AH DH AH  W AA  R AH 
पूनः		P UH  N AH 
पुग्छौ		P UH  G AH  CHA AH AH UH 
पिउनसक्छु		P AH IW N AH S AH K AH  CHA UH  
पाई		P AA  IH 
पल्टनुहोस्।		P AH L AH  T AH N UH  HH OH  S AH  
नोटहरु		N OH  T AH HH AH R UH  
निस्कने		N IH  S AH  K AH N EH  
नब्बे		N AH B AH  B EH  
दाँतको		DH AA N TH AH K OH  
त्यो के जस्तो देखिन्छ		TH AH  Y OH  DH EH  KA IH  N AH  CHA AH 
त्यसरी		TH AH  Y AH S AH R IH  
तोरी		TH OH  R IH  
तिरे		TH IH  R EH  
तिमीसँग		TH IH  M AH IH S AHN G AH 
तिनलाई		TH IH  N AH L AA  IH 
डाउनटाउन		D AA  UH N AH T AH AA UH N AH 
टोनिक		T OH  N IH  K AH 
टूइन		T UH  IH N AH 
जीलाई		JH IH  L AA  IH 
जान्छ।		JH AA  N AH  CHA AH 
जानेबाटो		JH AA  N EH  B AH AA T OH  
जानुभयो		JH AA  N UH  BA AH Y OH  
जन्मदिनको		JH AH N AH  M AH DH IH  N AH K OH  
चुक्ता		CH UH  K AH  TH AA  
चाँहि		CH AA N HH IH  
चढें।		CH AH DA EH  M
घाम		GA AA  M AH 
घांटी		GA AA  MT IH  
ग्रीन		G AH  R IH  N AH 
गाडि		G AA  D IH  
गर्दिनँ।		G AH R AH  DH IH  N AHN 
गर्छौँ।		G AH R AH  CHA AH UH N 
गरेँ।		G AH R EH N 
गरिपाउन		G AH R IH  P AA  UH N AH 
गराउने		G AH R AA  UH N EH  
गति		G AH TH IH  
खेल्छु।		KA EH  L AH  CHA UH  
खेलकुद		KA EH  L AH K UH  DH AH 
खानुस।		KA AA  N UH  S AH 
कार्यालयमा		K AA  R AH  Y AH AA L AH Y AH M AH AA 
कहिलेकाहीं		K AH HH IH  L EH  K AA  HH AH IH M
करोड		K AH R OH  D AH 
कम्पनिको		K AH M AH  P AH N IH  K OH  
कतिन्जेल		K AH TH IH  N AH  JH EH  L AH 
उपहारहरु		UH P AH HH AA  R AH HH AH R UH  
उत्तम		UH TH AH  TH AH M AH 
इ		IH 
आज बिदा हो।		AA JH AH 
आइसक्रिम		AA IH S AH K AH  R IH  M AH 
आ		AA 
अहले		AH HH AH L EH  
अचार		AH CH AA  R AH 
अगाड़ी		AH G AA  D IH  
ह्यामबर्गर		HH AH  Y AA  M AH B AH R AH  G AH R AH 
हुलाकद्वारा		HH UH  L AA  K AH DH AH  W AH AA R AH AA 
हवाइजहाज		HH AH W AA  IH JH AH HH AH AA JH AH 
हफ्ताको		HH AH PA AH  TH AA  K OH  
हट।		HH AH T AH 
स्थानिय		S AH  THA AA  N IH  Y AH 
स्टार		S AH  T AA  R AH 
सेन्टिमिटर		S EH  N AH  T IH  M AH IH T AH R AH 
सुहाएको		S UH  HH AA  EH K OH  
सुन्य		S UH  N AH  Y AH 
सुन्निएको		S UH  N AH  N IH  EH K OH  
सुझाब		S UH  JHA AA  B AH 
सुख्खा		S UH  KA AH  KA AA  
साधन		S AA  DHA AH N AH 
साट्ठी		S AA  T AH  TA IH  
सवा		S AH W AA  
सन्नुहोस्		S AH N AH  N UH  HH OH  S AH  
सँगैको		S AHN G AH IH  K OH  
विमानस्थलबाट		W IH  M AA  N AH S AH  THA AH L AH B AH AA T AH 
वयस्क।		W AH Y AH S AH  K AH 
वयस्कको		W AH Y AH S AH  K AH K OH  
लाग्न		L AA  G AH  N AH 
लण्डनमा		L AH N AH  D AH N AH M AA  
लगाउनुहुन्छ		L AH G AA  UH N UH  HH AH UH N AH  CHA AH 
रेलमार्गको		R EH  L AH M AA  R AH  G AH K OH  
रहन		R AH HH AH N AH 
रसिद।		R AH S IH  DH AH 
यहिँ		Y AH HH IH N 
मोड्नुहोस्		M OH  D AH  N UH  HH AH OH S AH  
माग		M AA  G AH 
भुटेको		BA UH  T EH  K OH  
भित्रमा		BA IH  TH AH  R AH M AA  
भित्रको		BA IH  TH AH  R AH K OH  
भव्यसँग		BA AH W AH  Y AH S AHN G AH 
भगवान।		BA AH G AH W AA  N AH 
बोर्डिङ गेट नम्बर कति हो		B OH  R AH  D IH  NG AH K AH TH AH IH 
बैक		B AH IH  K AH 
बिग्रिएको		B IH  G AH  R AH IH EH K OH  
बच्चाहरु		B AH CH AH  CH AA  HH AH R UH  
प्लग		P AH  L AH G AH 
प्राकृतिक		P AH  R AA  K AH R TH IH  K AH 
प्रशस्त		P AH  R AH S AH S AH  TH AH 
पोल्छ।		P OH  L AH  CHA AH 
पे		P EH  
पुर्याउन		P UH  R AH  Y AA  UH N AH 
पुनजारी		P UH  N AH JH AA  R IH  
पार्लर		P AA  R AH  L AH R AH 
पहिल्यै		P AH HH IH  L AH  Y AH AH IH 
पस्न		P AH S AH  N AH 
परिचयपत्र		P AH R IH  CH AH Y AH P AH TH AH  R AH 
पकाउन		P AH K AA  UH N AH 
निर्देशिका		N IH  R AH  DH EH  S AH IH K AA  
देखाई		DH EH  KA AA  IH 
दुर्घटनामा		DH UH  R AH  GA AH T AH N AA  M AH AA 
दिएँ।		DH IH  EHN 
दम		DH AH M AH 
थिएन		THA IH  EH N AH 
तुरन्तै		TH UH  R AH N AH  TH AH IH  
तिर्नेछु।		TH IH  R AH  N EH  CHA UH  
तालीका		TH AA  L IH  K AH AA 
ठेगानामा।		TA EH  G AA  N AH AA M AH AA 
झर्न		JHA AH R AH  N AH 
जून		JH UH  N AH 
जान्ने		JH AA  N AH  N EH  
जाच		JH AA  CH AH 
जाँदैन।		JH AA N DH AH IH  N AH 
जसले		JH AH S AH L EH  
जतिको		JH AH TH IH  K OH  
चिटिक्क		CH IH  T AH IH K AH  K AH 
चाख्न		CH AA  KA AH  N AH 
चलाउनुहोस्।		CH AH L AA  UH N UH  HH OH  S AH  
चलचित्रको		CH AH L AH CH IH  TH AH  R AH K OH  
गरिदिनुहुन्थ्यो		G AH R IH  DH AH IH N UH  HH AH UH N AH  THA AH  Y OH  
खाइसकेपछि		KA AA  IH S AH K EH  P AH CHA IH  
कोठा।		K OH  TA AA  
कार्डलाई		K AA  R AH  D AH L AH AA IH 
कम्मरको		K AH M AH  M AH R AH K OH  
ओपरेटर		OH P AH R EH  T AH R AH 
एस्ट्रे		EH S AH  T AH  R EH  
एक्स्प्रेस		EH K AH  S AH  P AH  R EH  S AH 
एकलकोठा		EH K AH L AH K OH  TA AA  
एंटीबायोटिकको		EH MT IH  B AA  Y OH  T AH IH K AH K AH OH 
उल्लेख		UH L AH  L EH  KA AH 
इच्छुक		IH CH AH  CHA UH  K AH 
आइदिनुहुन्छ		AA IH DH IH  N UH  HH AH UH N AH  CHA AH 
अर्को।		AH R AH  K OH  
अभ्यास		AH BA AH  Y AA  S AH 
अन्तमा		AH N AH  TH AH M AA  
अन		AH N AH 
हौं।		HH AH UH  M
हामीहरु		HH AA  M IH  HH AH R UH  
हाईड		HH AA  IH D AH 
हवाईजहाजमा		HH AH W AA  IH JH AH HH AH AA JH AH M AH AA 
हलको		HH AH L AH K OH  
स्कूलमा		S AH  K UH  L AH M AA  
सोधेको		S OH  DHA EH  K AH OH 
सेन्टका		S EH  N AH  T AH K AA  
सेकेण्ड		S EH  K AH EH N AH  D AH 
सुनिन।		S UH  N IH  N AH 
सिकाइदिनुहोस्		S IH  K AA  IH DH AH IH N UH  HH OH  S AH  
साथीहरुको		S AA  THA IH  HH AH R UH  K OH  
साटेर		S AA  T EH  R AH 
सर्विस।		S AH R AH  W IH  S AH 
सक्छौँ।		S AH K AH  CHA AH UH N 
व्यवसायको		W AH  Y AH W AH S AA  Y AH K OH  
विस्तृत		W IH  S AH  TH AH R TH AH 
वहाँ		W AH HH AA N 
लास		L AA  S AH 
लण्डनको		L AH N AH  D AH N AH K OH  
रेकर्ड		R EH  K AH R AH  D AH 
रात।		R AA  TH AH 
राउण्ड		R AA  UH N AH  D AH 
युनियन		Y UH  N IH  Y AH N AH 
यसो		Y AH S OH  
यसभित्र		Y AH S AH BA IH  TH AH  R AH 
म्याम्।		M AH  Y AA  M AH  
मिनट		M IH  N AH T AH 
माछाको		M AA  CHA AH AA K OH  
मंगलबार		M AH MG AH L AH B AA  R AH 
भेट्दा		BA EH  T AH  DH AA  
भेटेको		BA EH  T AH EH K OH  
भुक्तानि		BA UH  K AH  TH AA  N IH  
भुइंमा		BA UH  IH MM AA  
भागको		BA AA  G AH K OH  
भर्नु		BA AH R AH  N UH  
ब्यागको		B AH  Y AA  G AH K OH  
बोल्नसक्छु		B OH  L AH  N AH S AH K AH  CHA UH  
बुकिङग		B UH  K IH  NG AH G AH 
बीच		B IH  CH AH 
बानिदिनुहोला।		B AA  N IH  DH AH IH N UH  HH OH  L AH AA 
बादल		B AA  DH AH L AH 
बजेदेखि		B AH JH EH  DH AH EH KA IH  
फ्ल्यास		PA AH  L AH  Y AA  S AH 
फूल		PA UH  L AH 
फुटेको		PA UH  T EH  K OH  
फर्ने		PA AH R AH  N EH  
प्रदर्शनी		P AH  R AH DH AH R AH  S AH N IH  
पोस्टकार्डहरु		P OH  S AH  T AH K AA  R AH  D AH HH AH R UH  
पुग्नसक्छुहोला		P UH  G AH  N AH S AH K AH  CHA AH UH HH OH  L AA  
पुग्छौँ		P UH  G AH  CHA AH AH UHN 
पाउछु		P AA  UH CHA UH  
पाइन।		P AA  IH N AH 
पढाइ		P AH DA AA  IH 
नहिचकिचाईकन		N AH HH IH  CH AH K AH IH CH AA  IH K AH N AH 
धरौटीको		DHA AH R AH UH  T IH  K OH  
दुख्न		DH UH  KA AH  N AH 
दिन्छ		DH IH  N AH  CHA AH 
दयालुपनको		DH AH Y AA  L UH  P AH N AH K OH  
त्यतो		TH AH  Y AH TH OH  
तेश्रो		TH EH  S AH  R OH  
तीनमा		TH IH  N AH M AA  
डाईभिंग		D AA  IH BA IH  MG AH 
डाइभ		D AA  IH BA AH 
डलरसँग		D AH L AH R AH S AHN G AH 
टु		T UH  
टिकेटहरु।		T IH  K EH  T AH HH AH R UH  
झर्ने		JHA AH R AH  N EH  
जिम्मा		JH IH  M AH  M AA  
छालाले		CHA AA  L AH AA L EH  
छान्न		CHA AA  N AH  N AH 
छातीमा		CHA AA  TH IH  M AH AA 
चेकबाट		CH EH  K AH B AA  T AH 
ग्राण्ड		G AH  R AA  N AH  D AH 
गिलासको		G IH  L AA  S AH K OH  
गर्नुपर्दैन।		G AH R AH  N UH  P AH R AH  DH AH IH  N AH 
गराउनुहोस्।		G AH R AA  UH N UH  HH OH  S AH  
गदिनुहोस्।		G AH DH IH  N UH  HH OH  S AH  
खोकीको		KA OH  K IH  K AH OH 
खुद्राहरु		KA UH  DH AH  R AA  HH AH R AH UH 
क्रुज		K AH  R UH  JH AH 
क्यान्सिल		K AH  Y AA  N AH  S IH  L AH 
के भइराखेको छ मलाई		K EH  M AH L AA  IH 
कम्तीमा		K AH M AH  TH IH  M AA  
क		K AH 
ओसार्ने		OH S AA  R AH  N EH  
एसि		EH S IH  
एकदिने		EH K AH DH IH  N EH  
ऋतु		R IH TH UH  
उहा		UH HH AA  
उनीहरुलाई		UH N IH  HH AH R UH  L AA  IH 
आएका		AA EH K AA  
आउँदा		AA UHN DH AA  
अलग		AH L AH G AH 
अती		AH TH IH  
हेर्नुहोस		HH EH  R AH  N UH  HH OH  S AH 
हेर्नुहुन्छ		HH EH  R AH  N UH  HH AH UH N AH  CHA AH 
हुन्न।		HH UH  N AH  N AH 
हुन्छन्।		HH UH  N AH  CHA AH N AH  
हुन्छन्		HH UH  N AH  CHA AH N AH  
हुनुहुन्न		HH UH  N AH UH HH AH UH N AH  N AH 
हामीहरुको		HH AA  M IH  HH AH R UH  K OH  
स्थापना		S AH  THA AA  P AH N AH AA 
स्टोरमा		S AH  T OH  R AH M AA  
सुरू		S UH  R AH UH 
सुन्तला		S UH  N AH  TH AH L AA  
सीटमा		S IH  T AH M AA  
सिटहरू		S IH  T AH HH AH R UH  
सानोमा		S AA  N OH  M AH AA 
साकिन्छ		S AA  K IH  N AH  CHA AH 
सहभागी		S AH HH AH BA AA  G IH  
ससेज		S AH S EH  JH AH 
सम्बन्धी		S AH M AH  B AH N AH  DHA IH  
सम्झौता		S AH M AH  JHA AH UH  TH AA  
सकेसम्म		S AH K EH  S AH M AH  M AH 
सकेजति		S AH K EH  JH AH TH IH  
सकियो		S AH K IH  Y OH  
संकेत		S AH MK EH  TH AH 
शुन्ना		S UH  N AH  N AA  
शान्तकोठा		S AA  N AH  TH AH K OH  TA AH AA 
विवाह		W IH  W AA  HH AH 
विद्यार्थी		W IH  DH AH  Y AA  R AH  THA AH IH 
लिए		L IH  EH 
लायक		L AA  Y AH K AH 
लामोको		L AA  M OH  K AH OH 
लगाईदिनुहोस्।		L AH G AA  IH DH IH  N UH  HH OH  S AH  
लगाई		L AH G AA  IH 
लगाइहेर्न		L AH G AA  IH HH EH  R AH  N AH 
र।		R AH 
रेस्टुरेन्टहरु		R EH  S AH  T UH  R AH EH N AH  T AH HH AH R AH UH 
रहने		R AH HH AH N EH  
रद्ध		R AH DH AH  DHA AH 
रक्सि		R AH K AH  S IH  
मोडिनुहोस्		M OH  D IH  N UH  HH AH OH S AH  
मेन्यु		M EH  N AH  Y UH  
मेक्सिकन		M EH  K AH  S IH  K AH N AH 
मुटुको		M UH  T AH UH K OH  
मासुको		M AA  S UH  K OH  
मायामी		M AA  Y AH AA M IH  
माफ़		M AA  PA AH 
मसँगै		M AH S AHN G AH IH  
मज्जा		M AH JH AH  JH AA  
भैहाल्छ		BA AH IH  HH AA  L AH  CHA AH 
भेट्टाएको		BA EH  T AH  T AA  EH K OH  
भेट्छु।		BA EH  T AH  CHA UH  
भेटौं		BA EH  T AH UH  M
भव्य		BA AH W AH  Y AH 
भर्नुहोला।		BA AH R AH  N UH  HH OH  L AA  
भन्सारमा		BA AH N AH  S AA  R AH M AH AA 
ब्याट्रि		B AH  Y AA  T AH  R IH  
बोके		B OH  K EH  
बेच्न		B EH  CH AH  N AH 
बिहानै		B IH  HH AA  N AH AH IH 
बहिनी		B AH HH IH  N AH IH 
बस्नुभएको		B AH S AH  N UH  BA EH  K OH  
बस्नलाई		B AH S AH  N AH L AA  IH 
बस्छौ		B AH S AH  CHA AH UH  
बजेबाट		B AH JH EH  B AA  T AH 
फ्रिज		PA AH  R IH  JH AH 
फोटोहरु		PA OH  T AH OH HH AH R UH  
फाल्नुहोस्।		PA AA  L AH  N UH  HH OH  S AH  
फर्स्ट		PA AH R AH  S AH  T AH 
फर्कन्छु।		PA AH R AH  K AH N AH  CHA UH  
परीक्षण		P AH R IH  K AH  S AH N AH 
परिवारको		P AH R IH  W AA  R AH K OH  
पटक।		P AH T AH K AH 
न्युयोर्क		N AH  Y UH  Y OH  R AH  K AH 
नोटमा		N OH  T AH M AA  
निस्कियो।		N IH  S AH  K AH IH Y OH  
निस्किएँ।		N IH  S AH  K AH IH EHN 
निराश		N IH  R AA  S AH 
निःशुल्क		N IH  S UH  L AH  K AH 
नाममा		N AA  M AH M AH AA 
नकात।		N AH K AA  TH AH 
धारा		DHA AA  R AH AA 
दुखेर		DH UH  KA EH  R AH 
दुखी		DH UH  KA IH  
दुई।		DH UH  IH 
दिसा		DH IH  S AA  
दिमागमा		DH IH  M AA  G AH M AH AA 
दायाँतिर		DH AA  Y AH AAN TH IH  R AH 
थाल		THA AA  L AH 
त्यसतै		TH AH  Y AH S AH TH AH IH  
तीनजना		TH IH  N AH JH AH N AA  
तिरको		TH IH  R AH K OH  
तिनीहरुको		TH IH  N AH IH HH AH R UH  K OH  
तपाँइलाई		TH AH P AA N IH L AH AA IH 
ठुला		TA UH  L AA  
ट्वाइलेट		T AH  W AA  IH L EH  T AH 
ट्रे		T AH  R EH  
ट्राभलर		T AH  R AA  BA AH L AH R AH 
टेवल		T EH  W AH L AH 
टुइन		T UH  IH N AH 
जेन		JH EH  N AH 
जीवन		JH IH  W AH N AH 
जान्न		JH AA  N AH  N AH 
जान्छु		JH AA  N AH  CHA UH  
जानेछु।		JH AA  N EH  CHA UH  
छाप		CHA AA  P AH 
चुरोटहरु		CH UH  R OH  T AH HH AH R AH UH 
घन्टा		GA AH N AH  T AA  
गोरुको		G OH  R UH  K AH OH 
गुमाएँ।		G UH  M AA  EHN 
गर्भवती		G AH R AH  BA AH W AH TH IH  
गन्तब्य		G AH N AH  TH AH B AH  Y AH 
खाम		KA AA  M AH 
खाउँ		KA AA  UHN 
कोसेलीहरु		K OH  S EH  L IH  HH AH R UH  
कोक।		K OH  K AH 
किन्नुपर्छ		K IH  N AH  N UH  P AH R AH  CHA AH 
कागजमा		K AA  G AH JH AH M AH AA 
का		K AA  
कम्पनि		K AH M AH  P AH N IH  
कन्सर्टमा		K AH N AH  S AH R AH  T AH M AA  
एकदिनमा		EH K AH DH IH  N AH M AA  
उठाईदिनुहोला।		UH TA AA  IH DH IH  N UH  HH OH  L AH AA 
आयो		AA Y OH  
आउनुभयो।		AA UH N UH  BA AH Y OH  
आइपुग्छु।		AA IH P UH  G AH  CHA AH UH 
अन्तर		AH N AH  TH AH R AH 
होटेलसम्म।		HH OH  T EH  L AH S AH M AH  M AH 
हेर्छु		HH EH  R AH  CHA UH  
हेरे		HH EH  R AH EH 
हेरि		HH EH  R IH  
हुनै		HH UH  N AH IH  
हुनुपर्छ		HH UH  N AH UH P AH R AH  CHA AH 
हटाउन		HH AH T AA  UH N AH 
स्वास्थ्यको		S AH  W AA  S AH  THA AH  Y AH K OH  
स्ट्रिट		S AH  T AH  R IH  T AH 
स्कुबा		S AH  K UH  B AA  
सोध्नुहोस्।		S OH  DHA AH  N UH  HH AH OH S AH  
सोध्नु		S OH  DHA AH  N UH  
सुबिधा।		S UH  B IH  DHA AA  
सुनिएन।		S UH  N IH  EH N AH 
सुट्केस		S UH  T AH  K EH  S AH 
सुझाउ		S UH  JHA AA  UH 
सुचना		S UH  CH AH N AA  
सिक्न		S IH  K AH  N AH 
सिक्दै		S IH  K AH  DH AH AH IH 
सरल		S AH R AH L AH 
सरकारी		S AH R AH K AA  R IH  
समाचारपत्र		S AH M AA  CH AH AA R AH P AH TH AH  R AH 
सबैकुरा		S AH B AH IH  K UH  R AA  
सक्छुहोला		S AH K AH  CHA UH  HH OH  L AA  
संग्रालय		S AH MG AH  R AA  L AH Y AH 
शैलीको		S AH IH  L AH IH K OH  
शेराटन		S EH  R AA  T AH N AH 
वैदेशिक		W AH IH  DH EH  S AH IH K AH 
विषेश		W IH  S EH  S AH 
विशेषता		W IH  S EH  S AH TH AA  
विमानस्थलसम्म		W IH  M AA  N AH S AH  THA AH L AH S AH M AH  M AH 
वाई		W AA  IH 
ल्याएको		L AH  Y AA  EH K OH  
लुगाहरू		L UH  G AA  HH AH R AH UH 
लिनुहोला		L IH  N UH  HH OH  L AA  
लाग्।		L AA  G AH  
रेलमार्ग		R EH  L AH M AA  R AH  G AH 
राखिपाउन		R AA  KA IH  P AH AA UH N AH 
रङको		R AH NG AH K OH  
म्युजिकल		M AH  Y UH  JH IH  K AH L AH 
मुनि		M UH  N IH  
माल		M AA  L AH 
माथिको		M AA  THA IH  K OH  
मस्टर्ड		M AH S AH  T AH R AH  D AH 
मसाज		M AH S AA  JH AH 
मर्न		M AH R AH  N AH 
भोज		BA OH  JH AH 
भिन्न		BA IH  N AH  N AH 
भरि		BA AH R IH  
बोन		B OH  N AH 
बैठक		B AH IH  TA AH K AH 
बेलायती		B EH  L AA  Y AH TH IH  
बेर्नुहोस्।		B EH  R AH  N UH  HH OH  S AH  
बिबिरा		B IH  B AH IH R AA  
बाहिरको		B AA  HH IH  R AH K OH  
बाधा		B AA  DHA AH AA 
बाकी		B AA  K IH  
बस्टनको		B AH S AH  T AH N AH K OH  
बगिरहेको		B AH G IH  R AH HH EH  K OH  
फर्किन		PA AH R AH  K IH  N AH 
फर्कनु		PA AH R AH  K AH N UH  
प्रदर्सनी		P AH  R AH DH AH R AH  S AH N IH  
प्रत्यक्ष		P AH  R AH TH AH  Y AH K AH  S AH 
पैंतालिस		P AH IH  MTH AA  L AH IH S AH 
पेरिसमा		P EH  R IH  S AH M AA  
पुछ्ने		P UH  CHA AH  N EH  
पुग्छु।		P UH  G AH  CHA AH UH 
पुगेको		P UH  G EH  K OH  
पियानो		P IH  Y AA  N OH  
पाउनुहुनेछ।		P AA  UH N UH  HH AH UH N EH  CHA AH 
पाउनुभयो		P AA  UH N UH  BA AH Y OH  
पर्खिन		P AH R AH  KA IH  N AH 
परिवारलाई		P AH R IH  W AA  R AH L AH AA IH 
परिरहेको		P AH R IH  R AH HH EH  K OH  
पराउनुहुन्छ		P AH R AA  UH N UH  HH AH UH N AH  CHA AH 
पथ		P AH THA AH 
पढ्ने		P AH DA AH  N EH  
पढ्नको		P AH DA AH  N AH K OH  
पठाउनको		P AH TA AA  UH N AH K OH  
पठाइदिनुहुन्छ		P AH TA AA  IH DH IH  N UH  HH AH UH N AH  CHA AH 
पछाडिबाट		P AH CHA AA  D IH  B AH AA T AH 
नारिता		N AA  R IH  TH AH AA 
नापिदिनुहुन्छ		N AA  P IH  DH AH IH N UH  HH AH UH N AH  CHA AH 
नभए		N AH BA EH  
नछोउ		N AH CHA AH OW 
नगरको		N AH G AH R AH K OH  
धोएर		DHA OH  EH R AH 
धरौटी		DHA AH R AH UH  T IH  
देख्नु		DH EH  KA AH  N UH  
दूरीको		DH UH  R IH  K OH  
दुईसय		DH UH  IH S AH Y AH 
दुइटा		DH UH  IH T AA  
तान्ने		TH AA  N AH  N EH  
तपाँइ		TH AH P AA N IH 
डायल		D AA  Y AH L AH 
ट्याक्सी।		T AH  Y AA  K AH  S IH  
टेनिसकोर्ट		T EH  N IH  S AH K OH  R AH  T AH 
टुरको		T UH  R AH K OH  
टुईन		T UH  IH N AH 
टायरमा		T AA  Y AH R AH M AH AA 
झुम्काहरु		JHA UH  M AH  K AA  HH AH R AH UH 
जि		JH IH  
जानुस्।		JH AA  N UH  S AH  
जना।		JH AH N AA  
जनवरी		JH AH N AH W AH R IH  
छुटै		CHA UH  T AH IH  
चाखलाग्दो		CH AA  KA AH L AH AA G AH  DH OH  
चाख		CH AA  KA AH 
ग्रे		G AH  R EH  
गोलीगाँठो		G OH  L IH  G AA N TA AH OH 
गोडा		G OH  D AA  
गृहकार्य		G AH R HH AH K AA  R AH  Y AH 
गहना		G AH HH AH N AA  
गतिमा		G AH TH IH  M AA  
गइसक्यो।		G IH  S AH K AH  Y OH  
खानुभएको		KA AA  N UH  BA EH  K OH  
केटाको		K EH  T AA  K OH  
किनकि		K IH  N AH K AH IH 
कारबाट		K AA  R AH B AH AA T AH 
कम्प्युटर		K AH M AH  P AH  Y UH  T AH R AH 
कम्पनिमा		K AH M AH  P AH N IH  M AA  
कफ		K AH PA AH 
ओर्लन्छु।		OH R AH  L AH N AH  CHA UH  
उमालेको		UH M AA  L EH  K OH  
उड्ने		UH D AH  N EH  
उड्न		UH D AH  N AH 
ईस्त्री		IH S AH  TH AH  R IH  
आहस्मिक		AA HH AH S AH  M IH  K AH 
आउनेजाने		AA UH N EH  JH AA  N AH EH 
आईरहेको		AA IH R AH HH EH  K OH  
आइपुग्छ		AA IH P UH  G AH  CHA AH 
अवलोकन		AH W AH L OH  K AH N AH 
अपार्टमेन्ट		AH P AA  R AH  T AH M EH  N AH  T AH 
अपराह्नको		AH P AH R AA  HH AH  N AH K OH  
अन्डाको		AH N AH  D AA  K OH  
अनुहार		AH N UH  HH AA  R AH 
अक्षर		AH K AH  S AH R AH 
अंक		AH MK AH 
हेरेको		HH EH  R AH EH K OH  
हवाईजहाजबाट		HH AH W AA  IH JH AH HH AH AA JH AH B AH AA T AH 
हलिएको		HH AH L IH  EH K OH  
स्वरले		S AH  W AH R AH L EH  
सूचि		S UH  CH IH  
सुनको		S UH  N AH K OH  
सिपालु		S IH  P AA  L UH  
सार्नुहोस्।		S AA  R AH  N UH  HH OH  S AH  
सबैजना		S AH B AH IH  JH AH N AA  
सन्नी		S AH N AH  N IH  
सँगसँगै		S AHN G AH S AHN G AH IH  
शैलीमा		S AH IH  L AH IH M AA  
शुल्कमा		S UH  L AH  K AH M AA  
शिक्षक		S IH  K AH  S AH K AH 
शनिवार		S AH N IH  W AA  R AH 
शटर		S AH T AH R AH 
विश्राम		W IH  S AH  R AA  M AH 
वाउ		W AA  UH 
लाम		L AA  M AH 
रिबन		R IH  B AH N AH 
राखिने		R AA  KA IH  N EH  
रहोस्।		R AH HH OH  S AH  
यम		Y AH M AH 
यन		Y AH N AH 
मौसमको		M AH UH  S AH M AH K OH  
मै		M AH IH  
मेलाई		M EH  L AA  IH 
मिनी		M IH  N AH IH 
माईल		M AA  IH L AH 
महसूलको		M AH HH AH S UH  L AH K OH  
मन्च		M AH N AH  CH AH 
भेट्नको		BA EH  T AH  N AH K OH  
भेट्टाउनुभयो		BA EH  T AH  T AA  UH N UH  BA AH Y OH  
भवनमा		BA AH W AH N AH M AA  
भन्छ		BA AH N AH  CHA AH 
भनिदिन्छु।		BA AH N IH  DH AH IH N AH  CHA UH  
भएपछि		BA EH  P AH CHA IH  
ब्रिटिस		B AH  R IH  T AH IH S AH 
ब्यस्त		B AH  Y AH S AH  TH AH 
ब्यक्ति		B AH  Y AH K AH  TH IH  
बोलाउँछु।		B OH  L AA  UHN CHA UH  
बुझ्नुहुन्छ		B UH  JHA AH  N AH UH HH AH UH N AH  CHA AH 
बाक्लो		B AA  K AH  L OH  
बाकि		B AA  K IH  
बस्दा		B AH S AH  DH AA  
बत्तीमा		B AH TH AH  TH IH  M AA  
बताई		B AH TH AA  IH 
बजारमा		B AH JH AA  R AH M AH AA 
फ्री		PA AH  R IH  
फर्किनु		PA AH R AH  K IH  N UH  
प्ल्याटफर्मबाट		P AH  L AH  Y AA  T AH PA AH R AH  M AH B AH AA T AH 
प्रतिवेदन		P AH  R AH TH IH  W EH  DH AH N AH 
पूल		P UH  L AH 
पिन		P IH  N AH 
पानीसँग		P AA  N IH  S AHN G AH 
पाउनुहुन्छ।		P AA  UH N UH  HH AH UH N AH  CHA AH 
पन्ध्रको		P AH N AH  DHA AH  R AH K OH  
पठाइदिनु		P AH TA AA  IH DH IH  N UH  
निरको		N IH  R AH K OH  
देख्नुभएको		DH EH  KA AH  N UH  BA AH EH K OH  
दुखाईको		DH UH  KA AA  IH K OH  
दिनुभएको		DH IH  N UH  BA EH  K OH  
त्यो कति बेला सुरू हुन्छ		TH AH  Y OH  S UH  R AH UH 
तिरी		TH IH  R AH IH 
तिनिहरुलाई		TH IH  N AH IH HH AH R UH  L AA  IH 
तारिख।		TH AA  R IH  KA AH 
तल्लामा।		TH AH L AH  L AA  M AH AA 
तपाइँको		TH AH P AA  IHN K OH  
तन्नाहरु		TH AH N AH  N AA  HH AH R UH  
डिस्काउन्ट		D IH  S AH  K AA  UH N AH  T AH 
डिजाइन		D IH  JH AA  IH N AH 
ट्याक्सि		T AH  Y AA  K AH  S IH  
टुइनकोठा		T UH  IH N AH K OH  TA AA  
टन्न		T AH N AH  N AH 
झर्नु		JHA AH R AH  N UH  
झन्डै		JHA AH N AH  D AH IH  
जोन्स		JH OH  N AH  S AH 
जीको		JH IH  K OH  
जाँची		JH AA N CH IH  
छोड्नसक्छु		CHA OH  D AH  N AH S AH K AH  CHA UH  
छोडिदिनुहोस्।		CHA OH  D IH  DH AH IH N UH  HH AH OH S AH  
छुट्टीमा		CHA UH  T AH  T IH  M AA  
छुट्टि		CHA UH  T AH  T IH  
छुटा		CHA UH  T AA  
छिन्		CHA IH  N AH  
च्यानेल		CH AH  Y AA  N EH  L AH 
च्यानल		CH AH  Y AA  N AH L AH 
चीनी		CH IH  N AH IH 
चाहिँदैन		CH AA  HH IH N DH AH AH IH N AH 
चाहन्छु्।		CH AA  HH AH N AH  CHA UH   
चालु		CH AA  L UH  
चाईना		CH AA  IH N AH AA 
गाडा		G AA  D AH AA 
गाई		G AA  IH 
गर्नुहुन्छ।		G AH R AH  N UH  HH AH UH N AH  CHA AH 
गर्दैछौं।		G AH R AH  DH AH IH  CHA AH UH  M
गर्दछु।		G AH R AH  DH AH CHA UH  
गरिन।		G AH R IH  N AH 
खेर		KA EH  R AH 
खाएँ।		KA AA  EHN 
क्रीम		K AH  R IH  M AH 
केमिकल्सको		K EH  M IH  K AH L AH  S AH K OH  
कुनाको		K UH  N AA  K OH  
किलो		K IH  L OH  
किमोनो		K IH  M OH  N AH OH 
कामको		K AA  M AH K OH  
कापी		K AA  P IH  
करको		K AH R AH K OH  
कपडाहरु		K AH P AH D AA  HH AH R UH  
कन्डिसनर		K AH N AH  D IH  S AH N AH R AH 
ओर्लने		OH R AH  L AH N EH  
एयरपोर्टमा		EH Y AH R AH P OH  R AH  T AH M AA  
उपाय		UH P AA  Y AH 
उत्रन		UH TH AH  R AH N AH 
उड्छ		UH D AH  CHA AH 
आकार		AA K AA  R AH 
अहिलेलाई		AH HH IH  L EH  L AA  IH 
असाध्यै		AH S AA  DHA AH  Y AH IH  
अपेक्षा		AH P EH  K AH  S AA  
होलिडे		HH OH  L IH  D EH  
हील		HH IH  L AH 
हिमाल		HH IH  M AA  L AH 
हिड्न		HH IH  D AH  N AH 
हिटर		HH IH  T AH R AH 
हलकी		HH AH L AH K IH  
हन्थ्यो		HH AH N AH  THA AH  Y OH  
स्पोर्ट		S AH  P OH  R AH  T AH 
स्पेलिंग		S AH  P EH  L IH  MG AH 
स्ट्रीटमा		S AH  T AH  R IH  T AH M AA  
स्कार्फ		S AH  K AA  R AH  PA AH 
सून्य		S UH  N AH  Y AH 
सूटकेस		S UH  T AH K EH  S AH 
सुतेर		S UH  TH EH  R AH 
सुक्खा		S UH  K AH  KA AA  
सीट्		S IH  T AH  
सिकागोमा		S IH  K AA  G OH  M AH AA 
सिकागोको		S IH  K AA  G OH  K AH OH 
साथीहरु		S AA  THA IH  HH AH R UH  
साकाहारी		S AA  K AH AA HH AH AA R IH  
सस्ता		S AH S AH  TH AA  
सम्भावना		S AH M AH  BA AA  W AH N AH AA 
सपना		S AH P AH N AA  
सतही		S AH TH AH HH IH  
सगै		S AH G AH IH  
सकिरहेको		S AH K IH  R AH HH EH  K OH  
श्रेणी		S AH  R EH  N IH  
शुरुवात		S UH  R AH UH W AA  TH AH 
शाकाहारी		S AA  K AH AA HH AH AA R IH  
वेक		W EH  K AH 
लोसन		L OH  S AH N AH 
लेराईदिनुहोस्।		L EH  R AA  IH DH IH  N UH  HH OH  S AH  
लेखिदिन्छु।		L EH  KA IH  DH AH IH N AH  CHA UH  
लिईदिनुहुन्छ		L IH  IH DH AH IH N UH  HH AH UH N AH  CHA AH 
लाग्दै		L AA  G AH  DH AH IH  
लन्च		L AH N AH  CH AH 
लंद्री		L AH MDH AH  R IH  
रोक्छौ		R OH  K AH  CHA AH UH  
रोकीने		R OH  K IH  N EH  
रात्रीकालिन		R AA  TH AH  R IH  K AH AA L AH IH N AH 
रातोमा		R AA  TH OH  M AH AA 
रसीद		R AH S IH  DH AH 
रमाएँ।		R AH M AA  EHN 
यामामोतो		Y AA  M AH AA M OH  TH AH OH 
मेशिनमा		M EH  S IH  N AH M AA  
मूल्यसूची		M UH  L AH  Y AH S AH UH CH IH  
मिटरमा		M IH  T AH R AH M AA  
माया		M AA  Y AH AA 
मान्छेलाई		M AA  N AH  CHA EH  L AH AA IH 
माग्न		M AA  G AH  N AH 
महँगा		M AH HH AHN G AA  
मल		M AH L AH 
भैसकेको		BA AH IH  S AH K EH  K OH  
भै		BA AH IH  
भेट्टायौं		BA EH  T AH  T AA  Y AH UH  M
भईसक्यो।		BA IH  S AH K AH  Y OH  
ब्यागेजहरु		B AH  Y AA  G EH  JH AH HH AH R UH  
बोस्टनको		B OH  S AH  T AH N AH K AH OH 
बुझ्ने		B UH  JHA AH  N EH  
बीचको		B IH  CH AH K OH  
बल्छी		B AH L AH  CHA IH  
बनाइदिनुहुन्छ		B AH N AA  IH DH IH  N UH  HH AH UH N AH  CHA AH 
फ्लाइटमा		PA AH  L AA  IH T AH M AH AA 
फिका		PA IH  K AA  
फाउन्डेसन		PA AA  UH N AH  D EH  S AH N AH 
प्रोग्राम		P AH  R OH  G AH  R AA  M AH 
प्रसिध्द		P AH  R AH S IH  DHA AH  DH AH 
प्रसिद्द		P AH  R AH S IH  DH AH  DH AH 
प्रभावित		P AH  R AH BA AA  W IH  TH AH 
प्रतिदिनको		P AH  R AH TH IH  DH AH IH N AH K OH  
प्याकेज		P AH  Y AA  K EH  JH AH 
पोल्यो।		P OH  L AH  Y AH OH 
पो		P OH  
पैसालाई		P AH IH  S AA  L AH AA IH 
पेरिसको		P EH  R IH  S AH K OH  
पुस्तकालय		P UH  S AH  TH AH K AA  L AH Y AH 
पुनःजारी		P UH  N AH JH AA  R IH  
पुग्नको		P UH  G AH  N AH K OH  
पुगेन		P UH  G EH  N AH 
पिकासोको		P IH  K AA  S OH  K AH OH 
पार्किङग		P AA  R AH  K IH  NG AH G AH 
पाठ्यक्रम		P AA  TA AH  Y AH K AH  R AH M AH 
पाचँ		P AA  CH AHN 
पाउडर		P AA  UH D AH R AH 
पाइएला		P AA  IH EH L AH AA 
पर्खिनुहोस्		P AH R AH  KA IH  N UH  HH OH  S AH  
पत्रको		P AH TH AH  R AH K OH  
पट		P AH T AH 
पचपन्न		P AH CH AH P AH N AH  N AH 
निशाना।		N IH  S AA  N AH AA 
निर्धारित		N IH  R AH  DHA AA  R AH IH TH AH 
निकास		N IH  K AA  S AH 
नाचघर		N AA  CH AH GA AH R AH 
नगर्नु		N AH G AH R AH  N UH  
नगदले		N AH G AH DH AH L EH  
धोका		DHA OH  K AA  
देखिन।		DH EH  KA IH  N AH 
दुईमा		DH UH  IH M AA  
दिन्छ।		DH IH  N AH  CHA AH 
दिउसो		DH AH IW S OH  
थिइन्।		THA IH  IH N AH  
थाउजेन्ड		THA AA  UH JH EH  N AH  D AH 
त्यहीं		TH AH  Y AH HH IH  M
तिम्रोलागि		TH IH  M AH  R OH  L AA  G AH IH 
तिमिले		TH IH  M AH IH L EH  
तर।		TH AH R AH 
तर्फी।		TH AH R AH  PA IH  
तपाईं लाई पैसा तिर्न कस्तो लाग्छ		TH AH P AA  IH MTH IH  R AH  N AH 
ड्राइ		D AH  R AA  IH 
डेस्क।		D EH  S AH  K AH 
डीजर्ट		D IH  JH AH R AH  T AH 
डिएगो		D IH  EH G OH  
डाक्टरको		D AA  K AH  T AH R AH K OH  
ठ्याक्क		TA AH  Y AA  K AH  K AH 
ठाउँमा।		TA AA  UHN M AH AA 
टेबलको		T EH  B AH L AH K OH  
टिकेट।		T IH  K EH  T AH 
टापु		T AA  P UH  
टाइम्स		T AA  IH M AH  S AH 
जोड्ने		JH OH  D AH  N EH  
जोडिदिनुहोस्।		JH OH  D IH  DH AH IH N UH  HH AH OH S AH  
जोडिएको		JH OH  D IH  EH K AH OH 
जुत्ताहरू		JH UH  TH AH  TH AA  HH AH R AH UH 
जागिर		JH AA  G IH  R AH 
जाँचिदिनुहुन्छ		JH AA N CH IH  DH AH IH N UH  HH AH UH N AH  CHA AH 
छापिएको		CHA AA  P IH  EH K OH  
छत्तीस		CHA AH TH AH  TH IH  S AH 
चेरी		CH EH  R IH  
चाहियो		CH AA  HH IH  Y OH  
चाडो		CH AA  D OH  
चाइनिज		CH AA  IH N IH  JH AH 
चाँदी		CH AA N DH IH  
चश्मा		CH AH S AH  M AA  
चल्न		CH AH L AH  N AH 
चम्किलो		CH AH M AH  K IH  L OH  
चढ्नु		CH AH DA AH  N UH  
ग्लास		G AH  L AA  S AH 
ग्यासको		G AH  Y AA  S AH K OH  
गाडीबाट		G AA  D IH  B AH AA T AH 
गर्यौं।		G AH R AH  Y AH UH  M
गरु		G AH R UH  
गराउछौं।		G AH R AA  UH CHA AH UH  M
खोजिदिनुहोला।		KA OH  JH IH  DH AH IH N UH  HH AH OH L AA  
खेल्दैछन्		KA EH  L AH  DH AH IH  CHA AH N AH  
खिच्नुहोस्।		KA IH  CH AH  N UH  HH OH  S AH  
क्लासमा		K AH  L AA  S AH M AH AA 
क्लाइम		K AH  L AA  IH M AH 
क्यारेट		K AH  Y AA  R EH  T AH 
कोठालाई		K OH  TA AA  L AH AA IH 
केहीपनि		K EH  HH IH  P AH N AH IH 
किन्दा		K IH  N AH  DH AA  
कालोमा		K AA  L OH  M AH AA 
काटिदिनुहोस्।		K AA  T IH  DH AH IH N UH  HH OH  S AH  
कागजपत्र		K AA  G AH JH AH P AH TH AH  R AH 
कहिलेकाहिं		K AH HH IH  L EH  K AA  HH AH IH M
कसै		K AH S AH IH  
कष्ट		K AH S AH  T AH 
कफीको		K AH PA IH  K OH  
कपया		K AH P AH Y AA  
औंला		AH UN ML AA  
एच		EH CH AH 
एकलै		EH K AH L AH IH  
एउटा।		EW T AA  
ऊन		UH N AH 
उपयोग		UH P AH Y OH  G AH 
उधारो		UH DHA AA  R OH  
इतिहास		IH TH IH  HH AA  S AH 
इच्छा		IH CH AH  CHA AA  
आठको		AA TA AH K OH  
आउनुपर्छ		AA UH N UH  P AH R AH  CHA AH 
आउछ।		AA UH CHA AH 
अवस्थामा		AH W AH S AH  THA AA  M AH AA 
अमिलो		AH M IH  L OH  
अन्तिममा		AH N AH  TH IH  M AH M AA  
अन्तशुल्क		AH N AH  TH AH S UH  L AH  K AH 
होशियार		HH OH  S IH  Y AA  R AH 
हेरी		HH EH  R IH  
हुनेगरी		HH UH  N EH  G AH R IH  
हुँदैन		HH UH N DH AH IH  N AH 
हाल्न		HH AA  L AH  N AH 
हालें		HH AA  L EH  M
हातेझोला		HH AA  TH EH  JHA OH  L AH AA 
हलमा		HH AH L AH M AA  
हलका		HH AH L AH K AA  
हराएँ		HH AH R AA  EHN 
हराउनु		HH AH R AA  UH N UH  
हटाईदिनुहुन्छ		HH AH T AA  IH DH IH  N UH  HH AH UH N AH  CHA AH 
स्विच		S AH  W IH  CH AH 
सुलभ		S UH  L AH BA AH 
सुरुमा		S UH  R AH UH M AA  
सुटर		S UH  T AH R AH 
सिसा		S IH  S AA  
सार्ने		S AA  R AH  N EH  
सामानमा		S AA  M AH AA N AH M AH AA 
साप्ताहिक		S AA  P AH  TH AH AA HH IH  K AH 
सातमा		S AA  TH AH M AH AA 
साटो		S AA  T OH  
साइटसियिंग		S AA  IH T AH S IH  Y AH IH MG AH 
सहि		S AH HH IH  
सर्स्युं		S AH R AH  S AH  Y UH  M
सर्कस		S AH R AH  K AH S AH 
सरासर		S AH R AA  S AH R AH 
समाप्त		S AH M AA  P AH  TH AH 
सञ्चो		S AH N AH  CH OH  
सक्दिन		S AH K AH  DH IH  N AH 
सकाउनुभयो		S AH K AA  UH N UH  BA AH Y OH  
सकाउनु		S AH K AA  UH N UH  
शोको		S OH  K AH OH 
शास्त्रीय		S AA  S AH  TH AH  R IH  Y AH 
विषयमा		W IH  S AH Y AH M AA  
विदेशमा		W IH  DH EH  S AH M AA  
विक्री		W IH  K AH  R AH IH 
वाह।		W AA  HH AH 
वाशिंगटन		W AA  S IH  MG AH T AH N AH 
वयस्कहरुको		W AH Y AH S AH  K AH HH AH R UH  K OH  
ल्याइदिनुहोस्		L AH  Y AA  IH DH IH  N UH  HH OH  S AH  
लेखेर		L EH  KA AH EH R AH 
लिबर्टी		L IH  B AH R AH  T AH IH 
लिन्छौं।		L IH  N AH  CHA AH UH  M
लिन्छु		L IH  N AH  CHA UH  
लिनुभयो		L IH  N UH  BA AH Y OH  
लाने		L AA  N EH  
लाग।		L AA  G AH 
लागो		L AA  G OH  
लाउने		L AA  UH N EH  
लाइहेर्न		L AA  IH HH EH  R AH  N AH 
लम्ब्याउन		L AH M AH  B AH  Y AA  UH N AH 
रोकियो।		R OH  K IH  Y AH OH 
रेसर्भेसन		R EH  S AH R AH  BA AH EH S AH N AH 
रुटको		R UH  T AH K OH  
रील		R IH  L AH 
राख्नुहोस्		R AA  KA AH  N UH  HH OH  S AH  
राख्नुहुन्छ		R AA  KA AH  N UH  HH AH UH N AH  CHA AH 
रह्यो।		R AH HH AH  Y OH  
रसिदमा		R AH S IH  DH AH M AA  
रक्सीहरु		R AH K AH  S IH  HH AH R UH  
रंगहरु		R AH MG AH HH AH R UH  
योजनाहरु		Y OH  JH AH N AA  HH AH R UH  
योको		Y OH  K AH OH 
यो केको लागी हो		Y OH  HH AH OH 
याम्डा		Y AA  M AH  D AH AA 
यसपछि		Y AH S AH P AH CHA IH  
म्याप		M AH  Y AA  P AH 
मौसममा		M AH UH  S AH M AH M AA  
मोडल		M OH  D AH L AH 
मीटर		M IH  T AH R AH 
मिनरल		M IH  N AH R AH L AH 
महान		M AH HH AA  N AH 
महसूल		M AH HH AH S UH  L AH 
महशुस		M AH HH AH S UH  S AH 
मदतको		M AH DH AH TH AH K OH  
भोलिसम्म		BA OH  L IH  S AH M AH  M AH 
भुजिया।		BA UH  JH IH  Y AA  
भर्यो।		BA AH R AH  Y OH  
भरिदिनु		BA AH R IH  DH AH IH N UH  
भयानक		BA AH Y AA  N AH K AH 
भन्छु।		BA AH N AH  CHA UH  
भड्किलो		BA AH D AH  K IH  L OH  
ब्रिटिश		B AH  R IH  T AH IH S AH 
ब्यक्तिगत		B AH  Y AH K AH  TH IH  G AH TH AH 
बोल्छु।		B OH  L AH  CHA UH  
बेग्लै		B EH  G AH  L AH IH  
बुझे		B UH  JHA EH  
बिस्राम		B IH  S AH  R AA  M AH 
बिभिन्न		B IH  BA AH IH N AH  N AH 
बिचको		B IH  CH AH K OH  
बाल्ने		B AA  L AH  N EH  
बारको		B AA  R AH K OH  
बस्दैछौ		B AH S AH  DH AH IH  CHA AH UH  
फोहरा		PA OH  HH AH R AA  
प्रस्ताव		P AH  R AH S AH  TH AA  W AH 
प्रबेश		P AH  R AH B EH  S AH 
प्रत्येकको		P AH  R AH TH AH  Y EH  K AH K OH  
पैंतालीस		P AH IH  MTH AA  L AH IH S AH 
पार्टीको		P AA  R AH  T IH  K OH  
पारेको		P AA  R EH  K OH  
पाएकोमा		P AA  EH K OH  M AH AA 
पाइँदैन।		P AA  IHN DH AH IH  N AH 
पहिरन		P AH HH IH  R AH N AH 
पहिचान		P AH HH IH  CH AA  N AH 
पर्खिरहेको		P AH R AH  KA IH  R AH HH EH  K OH  
परम्परागत		P AH R AH M AH  P AH R AA  G AH TH AH 
पन्ध्र।		P AH N AH  DHA AH  R AH 
पठाउँछु।		P AH TA AA  UHN CHA UH  
न्यूयोर्कमा		N AH  Y UH  Y OH  R AH  K AH M AA  
निन्द्रा		N IH  N AH  DH AH  R AA  
नास्त		N AA  S AH  TH AH 
नहुनु		N AH HH UH  N AH UH 
नमुना		N AH M UH  N AA  
नखाने।		N AH KA AA  N EH  
धारणा		DHA AA  R AH N AH AA 
दृश्यावलोकनको		DH AH R S AH  Y AA  W AH L OH  K AH N AH K AH OH 
दुःख		DH UH  KA AH 
दिशा		DH IH  S AA  
दाँतमा		DH AA N TH AH M AH AA 
दशमा		DH AH S AH M AA  
थियौं।		THA IH  Y AH UH  M
थिइन।		THA IH  IH N AH 
थर		THA AH R AH 
त्यसले		TH AH  Y AH S AH L EH  
तेईस		TH AH EY S AH 
ताला		TH AA  L AH AA 
तारिकमा		TH AA  R IH  K AH M AH AA 
तस्विर		TH AH S AH  W IH  R AH 
तरीका		TH AH R IH  K AA  
ड्राइभरलाइसेन्स		D AH  R AA  IH BA AH R AH L AH AA IH S EH  N AH  S AH 
डाउन		D AA  UH N AH 
ट्रन्कमा		T AH  R AH N AH  K AH M AA  
ट्रंक		T AH  R AH MK AH 
टेबल।		T EH  B AH L AH 
टुरमा		T UH  R AH M AA  
टिप		T IH  P AH 
झोलाहरू		JHA OH  L AA  HH AH R UH  
ज्याक		JH AH  Y AA  K AH 
जाज		JH AA  JH AH 
छालामा		CHA AA  L AH AA M AH AA 
छान्नसक्छु		CHA AA  N AH  N AH S AH K AH  CHA UH  
चिजबर्गर		CH IH  JH AH B AH R AH  G AH R AH 
चिकित्सकले		CH IH  K AH IH TH AH  S AH K AH L EH  
चाडै		CH AA  D AH IH  
चाइना		CH AA  IH N AH AA 
चल्दै		CH AH L AH  DH AH IH  
चप्पल		CH AH P AH  P AH L AH 
घोडा		GA OH  D AA  
ग्राम		G AH  R AA  M AH 
गल्फको		G AH L AH  PA AH K OH  
गर।		G AH R AH 
गर्दिन।		G AH R AH  DH IH  N AH 
गफ		G AH PA AH 
गजबको		G AH JH AH B AH K OH  
खोज्नुभएको		KA OH  JH AH  N UH  BA EH  K AH OH 
खानुभयो		KA AA  N UH  BA AH Y OH  
क्योटो		K AH  Y OH  T AH OH 
कोइन		K OH  IH N AH 
कुखुरा		K UH  KA AH UH R AA  
किमुरा		K IH  M UH  R AA  
किनमेलको		K IH  N AH M EH  L AH K OH  
किताबहरू		K IH  TH AA  B AH HH AH R UH  
कम्मरमा		K AH M AH  M AH R AH M AA  
कममा		K AH M AH M AA  
कतिखेर		K AH TH IH  KA EH  R AH 
कक्षसेवा		K AH K AH  S AH S EH  W AA  
औषधिको		AH UN S AH DHA IH  K OH  
ऐड		IH  D AH 
एक्काईस		EH K AH  K AA  IH S AH 
एकछिन।		EH K AH CHA IH  N AH 
ऋतुमा		R IH TH UH  M AA  
उन्नाईस		UH N AH  N AA  IH S AH 
उत्सुक		UH TH AH  S UH  K AH 
इन्जेक्शन		IH N AH  JH EH  K AH  S AH N AH 
इन्जन		IH N AH  JH AH N AH 
इटाली		IH T AA  L IH  
आसा		AA S AA  
आरामले		AA R AA  M AH L EH  
आयात		AA Y AA  TH AH 
आफैं		AA PA AH IH  M
आपत्ति		AA P AH TH AH  TH IH  
आधी		AA DHA IH  
आधि		AA DHA IH  
आदेश		AA DH EH  S AH 
आजकल		AA JH AH K AH L AH 
आईपुग्न		AA IH P UH  G AH  N AH 
आइदिनुभएकोमा		AA IH DH IH  N UH  BA EH  K OH  M AA  
अस्पातअल		AH S AH  P AA  TH AH AH L AH 
अफ्		AH PA AH  
अन्डा		AH N AH  D AA  
होश		HH OH  S AH 
होटेलबाट		HH OH  T EH  L AH B AA  T AH 
होटे		HH OH  T EH  
हुलाकबाट		HH UH  L AA  K AH B AH AA T AH 
हुन।		HH UH  N AH 
हुन्छु		HH UH  N AH  CHA AH UH 
हिरा		HH IH  R AA  
हाइड		HH AA  IH D AH 
हवाइसेवा		HH AH W AA  IH S EH  W AH AA 
हल्लाखल्ला		HH AH L AH  L AA  KA AH L AH  L AH AA 
स्वाद।		S AH  W AA  DH AH 
स्प्रे		S AH  P AH  R EH  
सोल		S OH  L AH 
सुरक्षीत		S UH  R AH K AH  S IH  TH AH 
सुत्नुहोस्।		S UH  TH AH  N AH UH HH OH  S AH  
सुई		S UH  IH 
सीटको		S IH  T AH K OH  
सिफारीस		S IH  PA AA  R AH IH S AH 
सिङ्गल		S IH  NG AH  G AH L AH 
सामानहरुको		S AA  M AH AA N AH HH AH R UH  K OH  
सामन		S AA  M AH N AH 
साथीहरुसँग		S AA  THA IH  HH AH R UH  S AHN G AH 
साथीसँग		S AA  THA IH  S AHN G AH 
साग		S AA  G AH 
सम्पूर्ण		S AH M AH  P UH  R AH  N AH 
सक्नुहुनेछ।		S AH K AH  N UH  HH AH UH N EH  CHA AH 
संस्करण		S AH MS AH  K AH R AH N AH 
संग्रहालयमा		S AH MG AH  R AH HH AA  L AH Y AH M AH AA 
शून्य।		S UH  N AH  Y AH 
शूद्ध		S UH  DH AH  DHA AH 
शुक्रवार		S UH  K AH  R AH W AA  R AH 
शरीरको		S AH R IH  R AH K OH  
व्यापारी		W AH  Y AA  P AH AA R IH  
विश्व		W IH  S AH  W AH 
विदेश		W IH  DH EH  S AH 
वाइन्।		W AA  IH N AH  
वर्ल्ड		W AH R AH  L AH  D AH 
लिंदा		L IH  MDH AA  
लकर		L AH K AH R AH 
रेसेर्भेसनको		R EH  S AH EH R AH  BA AH EH S AH N AH K OH  
रेशम		R EH  S AH M AH 
रेन्टल		R EH  N AH  T AH L AH 
रसिदको		R AH S IH  DH AH K OH  
रंगीन		R AH MG IH  N AH 
यो घरको बिशेषता के हो		Y OH  K EH  
म्युजियम		M AH  Y UH  JH IH  Y AH M AH 
म्याम्		M AH  Y AA  M AH  
म्याद		M AH  Y AA  DH AH 
मुल्यको		M UH  L AH  Y AH K OH  
मिनेटजति		M IH  N EH  T AH JH AH TH AH IH 
मार्फत		M AA  R AH  PA AH TH AH 
मन्द		M AH N AH  DH AH 
मनपरेको		M AH N AH P AH R EH  K OH  
भेटौं।		BA EH  T AH UH  M
भित्री		BA IH  TH AH  R AH IH 
भित्रि		BA IH  TH AH  R AH IH 
भिक्टोरिया		BA IH  K AH  T OH  R AH IH Y AA  
भाग्यमानी		BA AA  G AH  Y AH M AH AA N IH  
भाँडो		BA AA N D OH  
ब्रेकफास्ट		B AH  R EH  K AH PA AA  S AH  T AH 
ब्रिफकेस		B AH  R IH  PA AH K EH  S AH 
ब्युटि		B AH  Y UH  T IH  
ब्यागमा		B AH  Y AA  G AH M AH AA 
बोल्नेकोही		B OH  L AH  N EH  K AH OH HH IH  
बोलाईदिनुहोस।		B OH  L AA  IH DH IH  N UH  HH AH OH S AH 
बोक्नुहुन्छ		B OH  K AH  N UH  HH AH UH N AH  CHA AH 
बिदेश		B IH  DH EH  S AH 
बाड्न		B AA  D AH  N AH 
बाईस		B AA  IH S AH 
बहिर		B AH HH IH  R AH 
बस्		B AH S AH  
बल्दैन।		B AH L AH  DH AH IH  N AH 
बर्बन		B AH R AH  B AH N AH 
बन्न		B AH N AH  N AH 
बनावट		B AH N AA  W AH T AH 
बढ्न		B AH DA AH  N AH 
बज्न		B AH JH AH  N AH 
बच्चालाई		B AH CH AH  CH AA  L AH AA IH 
फ्लू		PA AH  L UH  
फ्रान्सिस्कोमा		PA AH  R AA  N AH  S IH  S AH  K OH  M AH AA 
फ्रान्सिली		PA AH  R AA  N AH  S IH  L AH IH 
फेशन		PA EH  S AH N AH 
प्रार्थी		P AH  R AA  R AH  THA IH  
प्रश्नहरु		P AH  R AH S AH  N AH HH AH R UH  
प्रभाव		P AH  R AH BA AA  W AH 
प्रती		P AH  R AH TH IH  
प्रतिव्यक्ति		P AH  R AH TH IH  W AH  Y AH K AH  TH AH IH 
पौडि		P AH UH  D IH  
पोकाको		P OH  K AA  K AH OH 
पेश		P EH  S AH 
पुराना		P UH  R AA  N AH AA 
पुग्नुपर्छ।		P UH  G AH  N AH UH P AH R AH  CHA AH 
पुगिसक्यो।		P UH  G IH  S AH K AH  Y OH  
पार्किंग		P AA  R AH  K IH  MG AH 
पारिदिनुहुन्छ		P AA  R IH  DH AH IH N UH  HH AH UH N AH  CHA AH 
पानी।		P AA  N IH  
पाखुरा		P AA  KA UH  R AH AA 
पाऊँ		P AA  UHN 
पाउ।		P AA  UH 
पाइन्ट		P AA  IH N AH  T AH 
पहिलेनै		P AH HH IH  L EH  N AH AH IH 
पर्खेर		P AH R AH  KA EH  R AH 
पठाउनु		P AH TA AA  UH N UH  
न्यास्रो		N AH  Y AA  S AH  R OH  
नोटलाई		N OH  T AH L AA  IH 
निस्किन्छ।		N IH  S AH  K AH IH N AH  CHA AH 
निम्ति		N IH  M AH  TH AH IH 
निजि		N IH  JH AH IH 
नास्तामा		N AA  S AH  TH AH AA M AH AA 
नाडी		N AA  D IH  
नाच्नसक्छु		N AA  CH AH  N AH S AH K AH  CHA UH  
नहुनुहोस्।		N AH HH UH  N AH UH HH OH  S AH  
नङ्ग		N AH NG AH  G AH 
नगर्नुहोला।		N AH G AH R AH  N UH  HH OH  L AA  
नगरिकन		N AH G AH R IH  K AH N AH 
नंग		N AH MG AH 
देखि।		DH EH  KA IH  
देखाउनुहोस।		DH EH  KA AA  UH N UH  HH OH  S AH 
देखना		DH EH  KA AH N AA  
दृश्यावालोकन		DH AH R S AH  Y AA  W AH AA L OH  K AH N AH 
दुरी		DH UH  R IH  
दिएर		DH IH  EH R AH 
दिएकोले		DH IH  EH K OH  L EH  
त्यहाँसम्म		TH AH  Y AH HH AA N S AH M AH  M AH 
त्यत्ति		TH AH  Y AH TH AH  TH IH  
तीनसय		TH IH  N AH S AH Y AH 
तीनको		TH IH  N AH K OH  
तिर्नुहोला।		TH IH  R AH  N UH  HH OH  L AA  
तिर्छु		TH IH  R AH  CHA UH  
तल्ला		TH AH L AH  L AA  
तनका		TH AH N AH K AA  
तट		TH AH T AH 
तखतामा		TH AH KA AH TH AA  M AH AA 
डिनरको		D IH  N AH R AH K OH  
डगी		D AH G IH  
ठाउँहरू		TA AA  UHN HH AH R UH  
ट्रीप		T AH  R IH  P AH 
ट्राब्लर्स		T AH  R AA  B AH  L AH R AH  S AH 
टबको		T AH B AH K OH  
झण्डै		JHA AH N AH  D AH IH  
जोड्नुहोस्।		JH OH  D AH  N UH  HH AH OH S AH  
जेएयल		JH EH  EH Y AH L AH 
जिम्मेवार		JH IH  M AH  M EH  W AA  R AH 
जाऊँ		JH AA  UHN 
जन्म		JH AH N AH  M AH 
छक्क		CHA AH K AH  K AH 
चोरिको		CH OH  R IH  K AH OH 
चिनी।		CH IH  N AH IH 
चाहिँदैन।		CH AA  HH IH N DH AH AH IH N AH 
चार्ट		CH AA  R AH  T AH 
चलिराखेको		CH AH L IH  R AA  KA EH  K OH  
चलन		CH AH L AH N AH 
चमेनाघर		CH AH M EH  N AA  GA AH R AH 
चढे		CH AH DA EH  
घुमाउने		GA UH  M AA  UH N EH  
घुमफिरको		GA UH  M AH PA IH  R AH K OH  
गार्डेन		G AA  R AH  D EH  N AH 
गर्यो।		G AH R AH  Y OH  
गर्यो		G AH R AH  Y OH  
गर्नुहोस््		G AH R AH  N UH  HH OH  S AH   
गर्छन्		G AH R AH  CHA AH N AH  
गरिरहेका		G AH R IH  R AH HH EH  K AA  
गराइदिनुहोला।		G AH R AA  IH DH IH  N UH  HH OH  L AH AA 
खोजिदिन		KA OH  JH IH  DH AH IH N AH 
खुट्टाको		KA UH  T AH  T AA  K OH  
खिच्नुहुन्छ		KA IH  CH AH  N UH  HH AH UH N AH  CHA AH 
खरानी		KA AH R AA  N IH  
क्यासेट		K AH  Y AA  S EH  T AH 
क्यामेरामा		K AH  Y AA  M EH  R AH AA M AH AA 
क्याट्स		K AH  Y AA  T AH  S AH 
कृपय		K AH R P AH Y AH 
किन्नुभयो		K IH  N AH  N UH  BA AH Y OH  
किनें		K IH  N EH  M
कार्ट		K AA  R AH  T AH 
कलाको		K AH L AA  K OH  
कन्सर्टको		K AH N AH  S AH R AH  T AH K OH  
कथा		K AH THA AA  
औसधि		AH UN S AH DHA IH  
ओर्केस्ट्रा		OH R AH  K EH  S AH  T AH  R AA  
ओपरेटर।		OH P AH R EH  T AH R AH 
एस्		EH S AH  
एरियाकोड		EH R IH  Y AA  K OH  D AH 
एबिसि		EH B IH  S AH IH 
एक्स्		EH K AH  S AH  
एकदिन		EH K AH DH IH  N AH 
ऊसले		UH S AH L EH  
ऊपहार		UH P AH HH AA  R AH 
ऊनान्सय		UH N AA  N AH  S AH Y AH 
उनीहरू		UH N IH  HH AH R UH  
उताको		UH TH AA  K OH  
उडानहरू		UH D AA  N AH HH AH R UH  
उच्चारण		UH CH AH  CH AA  R AH N AH 
इयरफोन		IH Y AH R AH PA OH  N AH 
आस्पिरिन		AA S AH  P IH  R AH IH N AH 
आए		AA EH 
आउनुहुन्न		AA UH N UH  HH AH UH N AH  N AH 
आउनुभएकोमा		AA UH N UH  BA EH  K OH  M AA  
अघिनै		AH GA IH  N AH AH IH 
ह्वस्की		HH AH  W AH S AH  K IH  
होचो		HH OH  CH AH OH 
हेलो।		HH EH  L OH  
हेरौँ		HH EH  R AH UH N 
हेरिदिन		HH EH  R IH  DH AH IH N AH 
हुदैन।		HH UH  DH AH IH  N AH 
हालिदिनुहुन्थ्यो		HH AA  L IH  DH AH IH N UH  HH AH UH N AH  THA AH  Y OH  
हालि		HH AA  L IH  
हातेब्याग		HH AA  TH EH  B AH  Y AH AA G AH 
हा		HH AA  
हरुको		HH AH R UH  K OH  
हटाउने		HH AH T AA  UH N EH  
स्थानान्तरण		S AH  THA AA  N AH AA N AH  TH AH R AH N AH 
स्टेसनको		S AH  T EH  S AH N AH K OH  
स्टेशनसम्म		S AH  T EH  S AH N AH S AH M AH  M AH 
स्टिक		S AH  T IH  K AH 
सौचालय		S AH UH  CH AA  L AH Y AH 
सोध्छु।		S OH  DHA AH  CHA UH  
सोच्नुहुन्छ		S OH  CH AH  N UH  HH AH UH N AH  CHA AH 
सेवाबाट		S EH  W AA  B AH AA T AH 
सुविधाजनक		S UH  W IH  DHA AA  JH AH N AH K AH 
सुनिएको		S UH  N IH  EH K OH  
सुकाउने		S UH  K AA  UH N EH  
सिटि		S IH  T AH IH 
सिटहरु।		S IH  T AH HH AH R UH  
सिक्दैछु।		S IH  K AH  DH AH AH IH CHA UH  
सिकाईदिनुहुन्छ		S IH  K AA  IH DH AH IH N UH  HH AH UH N AH  CHA AH 
सारै		S AA  R AH IH  
सामानका		S AA  M AH AA N AH K AH AA 
सानो।		S AA  N OH  
साथीले		S AA  THA IH  L EH  
सहानुभूति		S AH HH AA  N UH  BA AH UH TH IH  
सस्		S AH S AH  
सशुल्क		S AH S UH  L AH  K AH 
सर्विस्।		S AH R AH  W IH  S AH  
सर्विस		S AH R AH  W IH  S AH 
समुह		S AH M UH  HH AH 
समस्याको		S AH M AH S AH  Y AA  K OH  
सफल		S AH PA AH L AH 
सन्तुष्ट		S AH N AH  TH UH  S AH  T AH 
सदस्य		S AH DH AH S AH  Y AH 
सक्यो।		S AH K AH  Y OH  
सके।		S AH K EH  
संख्या		S AH MKA AH  Y AA  
श्वास		S AH  W AA  S AH 
श्रीमान।		S AH  R IH  M AA  N AH 
शैली		S AH IH  L AH IH 
शावरको		S AA  W AH R AH K OH  
व्यवसायमा।		W AH  Y AH W AH S AA  Y AH M AH AA 
वेटर		W EH  T AH R AH 
विमानमा		W IH  M AA  N AH M AH AA 
वास्तविक		W AA  S AH  TH AH W IH  K AH 
वातावरण		W AA  TH AH AA W AH R AH N AH 
वातानाबे		W AA  TH AH AA N AH AA B EH  
वाइ		W AA  IH 
वर्षमा		W AH R AH  S AH M AA  
वर्ग		W AH R AH  G AH 
लोक		L OH  K AH 
लेराउँ		L EH  R AA  UHN 
लिनैपर्छ		L IH  N AH AH IH P AH R AH  CHA AH 
लिनुहोस््।		L IH  N UH  HH OH  S AH   
लागेर		L AA  G EH  R AH 
लाइ		L AA  IH 
ला		L AA  
लगाइदिनुहोला।		L AH G AA  IH DH IH  N UH  HH OH  L AH AA 
लक्षणहरु		L AH K AH  S AH N AH HH AH R UH  
रेयर		R EH  Y AH R AH 
रुगा		R UH  G AA  
रिसेप्सन		R IH  S EH  P AH  S AH N AH 
रिसाउँदिन।		R IH  S AA  UHN DH AH IH N AH 
रिस		R IH  S AH 
राज्यमा		R AA  JH AH  Y AH M AH AA 
राख्नसक्छु		R AA  KA AH  N AH S AH K AH  CHA UH  
रहनुभएको		R AH HH AH N UH  BA EH  K OH  
रहदानी।		R AH HH AH DH AA  N IH  
रंगशालामा		R AH MG AH S AA  L AH AA M AH AA 
रंगशाला		R AH MG AH S AA  L AH AA 
रँगको		R AHN G AH K OH  
यिनी		Y IH  N AH IH 
यन्त्र		Y AH N AH  TH AH  R AH 
यताबाट		Y AH TH AA  B AH AA T AH 
मेलबक्स		M EH  L AH B AH K AH  S AH 
मेरोकोठामा		M EH  R OH  K AH OH TA AA  M AH AA 
मूल्यको		M UH  L AH  Y AH K OH  
मिलाएर		M IH  L AA  EH R AH 
मिनेटभित्र		M IH  N EH  T AH BA AH IH TH AH  R AH 
मात्रै।		M AA  TH AH  R AH IH  
माइलको		M AA  IH L AH K OH  
महिलाहरु		M AH HH IH  L AA  HH AH R UH  
मध्यमबाट		M AH DHA AH  Y AH M AH B AA  T AH 
मगाउनसक्छु		M AH G AA  UH N AH S AH K AH  CHA UH  
मँगाएको		M AHN G AA  EH K OH  
भोजमा		BA OH  JH AH M AA  
भाँचियो।		BA AA N CH IH  Y OH  
भर्नुपर्छ		BA AH R AH  N UH  P AH R AH  CHA AH 
भन्नुभयो।		BA AH N AH  N UH  BA AH Y OH  
भई		BA IH  
ब्रान्डको		B AH  R AA  N AH  D AH K OH  
ब्रन्केट		B AH  R AH N AH  K EH  T AH 
बोलाको		B OH  L AA  K AH OH 
बुबा		B UH  B AA  
बीमाको		B IH  M AA  K OH  
बिराएँ।		B IH  R AA  EHN 
बिमानमा		B IH  M AA  N AH M AH AA 
बिध्यार्थी		B IH  DHA AH  Y AA  R AH  THA AH IH 
बस्नुहोला।		B AH S AH  N UH  HH OH  L AA  
बल्ल		B AH L AH  L AH 
बर्णन		B AH R AH  N AH N AH 
बनाइएको		B AH N AA  IH EH K OH  
बजेसम्मको		B AH JH EH  S AH M AH  M AH K OH  
बजाउँछन्		B AH JH AA  UHN CHA AH N AH  
बक्सिस		B AH K AH  S IH  S AH 
फ्रान्सेली		PA AH  R AA  N AH  S EH  L IH  
फोहर		PA OH  HH AH R AH 
फलफूलको		PA AH L AH PA UH  L AH K OH  
फर्केको		PA AH R AH  K EH  K OH  
प्लाटफर्म		P AH  L AA  T AH PA AH R AH  M AH 
प्रहरीचौकी		P AH  R AH HH AH R IH  CH AH UH  K AH IH 
पुर्याउँछ		P UH  R AH  Y AA  UHN CHA AH 
पार्कसम्म		P AA  R AH  K AH S AH M AH  M AH 
पहाड		P AH HH AA  D AH 
पसलबाट		P AH S AH L AH B AA  T AH 
पत्रिकाहरू		P AH TH AH  R IH  K AA  HH AH R UH  
पचासी		P AH CH AA  S IH  
न्यूयोर्कको		N AH  Y UH  Y OH  R AH  K AH K AH OH 
नोटबुक		N OH  T AH B UH  K AH 
नीति		N IH  TH AH IH 
निस्किन		N IH  S AH  K AH IH N AH 
नियमित।		N IH  Y AH M AH IH TH AH 
नदि		N AH DH IH  
नंबरको		N AH MB AH R AH K OH  
धून		DHA UH  N AH 
धन्यावाद।		DHA AH N AH  Y AA  W AH AA DH AH 
धन्ना		DHA AH N AH  N AA  
द्धारा		DH AH  DHA AA  R AH AA 
दोहोर्याएर		DH OH  HH AH OH R AH  Y AA  EH R AH 
देखाएको		DH EH  KA AA  EH K OH  
देखा		DH EH  KA AA  
दूतावासमा		DH UH  TH AA  W AH AA S AH M AH AA 
दुब्लो		DH UH  B AH  L OH  
दुखाइ		DH UH  KA AA  IH 
दुख		DH UH  KA AH 
दुईको		DH UH  IH K OH  
दिनहरु		DH IH  N AH HH AH R UH  
दिउँ		DH AH IWN 
थोक		THA OH  K AH 
थप्न		THA AH P AH  N AH 
त्यहाँँ		TH AH  Y AH HH AA N N 
तिनको		TH IH  N AH K OH  
तल्ला।		TH AH L AH  L AA  
ढुवानि		DA UH  W AA  N IH  
ड्रेसिंग		D AH  R EH  S IH  MG AH 
डिब्बा		D IH  B AH  B AA  
डाबर		D AA  B AH R AH 
डाईभ		D AA  IH BA AH 
डलरले		D AH L AH R AH L EH  
डलरलाई		D AH L AH R AH L AA  IH 
डब्लु		D AH B AH  L UH  
डकैतीको		D AH K AH IH  TH AH IH K OH  
ठोलो।		TA OH  L AH OH 
ठाउँबाट		TA AA  UHN B AH AA T AH 
ट्रयाक		T AH  R AH Y AA  K AH 
ट्रफिक		T AH  R AH PA IH  K AH 
ट्रंकमा		T AH  R AH MK AH M AA  
टाइ		T AA  IH 
टर्की		T AH R AH  K IH  
झार		JHA AA  R AH 
जिस्किंदै		JH IH  S AH  K AH IH MDH AH AH IH 
जिरो		JH IH  R OH  
जालको		JH AA  L AH K OH  
जारिगरिदिनु		JH AA  R IH  G AH R AH IH DH AH IH N UH  
जनालाई		JH AH N AA  L AH AA IH 
छोडिदिने		CHA OH  D IH  DH AH IH N EH  
छुट्टिमा		CHA UH  T AH  T IH  M AA  
छनौट		CHA AH N AH UH  T AH 
चिम		CH IH  M AH 
चिन्हको		CH IH  N AH  HH AH K OH  
चिजहरु		CH IH  JH AH HH AH R UH  
चाहानुहुन्छ		CH AA  HH AH AA N UH  HH AH UH N AH  CHA AH 
चाहनुहुन्थ्यो		CH AA  HH AH N UH  HH AH UH N AH  THA AH  Y OH  
चारमा		CH AA  R AH M AH AA 
चाँही		CH AA N HH IH  
चहकिलो		CH AH HH AH K IH  L OH  
चलाईदिनुहुन्छ		CH AH L AA  IH DH IH  N UH  HH AH UH N AH  CHA AH 
चर्को		CH AH R AH  K OH  
चम्कीलो		CH AH M AH  K IH  L OH  
घडीको		GA AH D IH  K OH  
ग्राहक		G AH  R AA  HH AH K AH 
गुड्ने		G UH  D AH  N EH  
गिर्जाघर		G IH  R AH  JH AA  GA AH R AH 
गिजा		G IH  JH AA  
गर्मीमा		G AH R AH  M IH  M AA  
गरेछु।		G AH R EH  CHA UH  
गरिसकेको		G AH R IH  S AH K EH  K OH  
गराईदिनुहुन्छ		G AH R AA  IH DH IH  N UH  HH AH UH N AH  CHA AH 
गयो		G AH Y OH  
खोलिदिन		KA OH  L IH  DH AH IH N AH 
खेल्दै		KA EH  L AH  DH AH IH  
खिचौं		KA IH  CH AH UH  M
खानुहुँदैन।		KA AA  N UH  HH AH UHN DH AH IH  N AH 
खस्यो।		KA AH S AH  Y OH  
खल्तीमा		KA AH L AH  TH IH  M AA  
क्लिप		K AH  L IH  P AH 
क्रिपय		K AH  R IH  P AH Y AH 
क्याबिन		K AH  Y AA  B IH  N AH 
केन्द्रमा		K EH  N AH  DH AH  R AH M AA  
केन्ट		K EH  N AH  T AH 
केन		K EH  N AH 
केचअप		K EH  CH AH AH P AH 
कुम		K UH  M AH 
कुकुर		K UH  K AH UH R AH 
किराले		K IH  R AA  L EH  
किनार		K IH  N AA  R AH 
कासिएको		K AA  S IH  EH K OH  
कार्यालयको		K AA  R AH  Y AH AA L AH Y AH K OH  
कार्यसमय		K AA  R AH  Y AH S AH M AH Y AH 
कारले		K AA  R AH L EH  
काटी		K AA  T IH  
कस्टम		K AH S AH  T AH M AH 
कलाकारहरू		K AH L AA  K AH AA R AH HH AH R UH  
करसहित		K AH R AH S AH HH IH  TH AH 
कम्प्यूटर		K AH M AH  P AH  Y UH  T AH R AH 
कम्पनीलाई		K AH M AH  P AH N IH  L AA  IH 
कभरेज		K AH BA AH R EH  JH AH 
कतिघण्टा		K AH TH IH  GA AH N AH  T AA  
ओर्लनुपर्छ		OH R AH  L AH N UH  P AH R AH  CHA AH 
ओभरनाईट		OH BA AH R AH N AA  IH T AH 
ओछ्यान		OH CHA AH  Y AA  N AH 
एन्जल्स		EH N AH  JH AH L AH  S AH 
एक्सप्रेसको		EH K AH  S AH P AH  R EH  S AH K OH  
एक्सटेंशन		EH K AH  S AH T EH  MS AH N AH 
एकल		EH K AH L AH 
ऊपहारमा		UH P AH HH AA  R AH M AH AA 
उहाँहरुलाई		UH HH AA N HH AH R UH  L AH AA IH 
उठ्न		UH TA AH  N AH 
इश्यू		IH S AH  Y UH  
आहिले		AA HH IH  L EH  
आश्चर्यजनक		AA S AH  CH AH R AH  Y AH JH AH N AH K AH 
आयौ।		AA Y AH UH  
आठमा		AA TA AH M AA  
आउनेछ।		AA UH N EH  CHA AH 
आईज।		AA IH JH AH 
आइसक्रीम		AA IH S AH K AH  R IH  M AH 
अस्वस्थता		AH S AH  W AH S AH  THA AH TH AA  
असली		AH S AH L IH  
अवलोकनको		AH W AH L OH  K AH N AH K AH OH 
अरुनै		AH R UH  N AH IH  
अफिसर		AH PA IH  S AH R AH 
अप।		AH P AH 
अन्तराष्ट्रीय		AH N AH  TH AH R AA  S AH  T AH  R IH  Y AH 
अनौपचारिक		AH N AH UH  P AH CH AA  R IH  K AH 
अनुसन्धान		AH N UH  S AH N AH  DHA AA  N AH 
अध्यन		AH DHA AH  Y AH N AH 
अग्रिम		AH G AH  R IH  M AH 
होनोलुलु		HH OH  N AH OH L UH  L AH UH 
होटेल।		HH OH  T EH  L AH 
हेरेर		HH EH  R AH EH R AH 
हेरिदिनुहोला।		HH EH  R IH  DH AH IH N UH  HH OH  L AA  
हुनेथिएँ।		HH UH  N EH  THA IH  EHN 
हुनाले		HH UH  N AA  L EH  
हुनसक्छु		HH UH  N AH S AH K AH  CHA AH UH 
हुदै		HH UH  DH AH IH  
हुँन्छ		HH UH N N AH  CHA AH 
हिँडेर		HH IH N D EH  R AH 
हावाको		HH AA  W AH AA K OH  
हालिदिनुहोस्।		HH AA  L IH  DH AH IH N UH  HH OH  S AH  
हालिदिनुहुन्छ		HH AA  L IH  DH AH IH N UH  HH AH UH N AH  CHA AH 
हामबर्गर		HH AA  M AH B AH R AH  G AH R AH 
हड्डी		HH AH D AH  D IH  
हईन।		HH IH  N AH 
हँ।		HH AHN 
स्वाश्थ		S AH  W AA  S AH  THA AH 
स्वादको		S AH  W AA  DH AH K OH  
स्वरमा		S AH  W AH R AH M AA  
स्पेसल		S AH  P EH  S AH L AH 
स्नातक		S AH  N AA  TH AH K AH 
स्टिकर		S AH  T IH  K AH R AH 
सोया		S OH  Y AA  
सोधेर		S OH  DHA EH  R AH 
सोच्नुहोस्।		S OH  CH AH  N UH  HH AH OH S AH  
सोचन		S OH  CH AH N AH 
सेटको		S EH  T AH K OH  
सुरुंगमार्ग		S UH  R AH UH MG AH M AA  R AH  G AH 
सुन्नुहोस्।		S UH  N AH  N AH UH HH OH  S AH  
सुन्तालाको		S UH  N AH  TH AA  L AH AA K OH  
सुनाउनुहोस्।		S UH  N AA  UH N AH UH HH OH  S AH  
सीटहरु		S IH  T AH HH AH R UH  
सिस्टम		S IH  S AH  T AH M AH 
सित		S IH  TH AH 
सिटहरुको		S IH  T AH HH AH R UH  K OH  
सावधान।		S AA  W AH DHA AH AA N AH 
साल्मोन		S AA  L AH  M OH  N AH 
सामुन्द्र		S AA  M UH  N AH  DH AH  R AH 
साधारणतया		S AA  DHA AH AA R AH N AH TH AH Y AH AA 
साटी		S AA  T IH  
सर्टिफिकेट		S AH R AH  T IH  PA AH IH K EH  T AH 
सम्बन्ध		S AH M AH  B AH N AH  DHA AH 
समाउनसक्छु		S AH M AA  UH N AH S AH K AH  CHA UH  
सटल		S AH T AH L AH 
सगँ		S AH G AHN 
संगसंगै		S AH MG AH S AH MG AH IH  
सँगैकोकोठामा		S AHN G AH IH  K OH  K AH OH TA AA  M AH AA 
शुक्रबारको		S UH  K AH  R AH B AA  R AH K OH  
शिकागोमा		S IH  K AA  G OH  M AH AA 
व्यक्तिविशेष		W AH  Y AH K AH  TH IH  W AH IH S EH  S AH 
वारेन्टी		W AA  R EH  N AH  T IH  
वाइन।		W AA  IH N AH 
वहुमूल्य		W AH HH UH  M AH UH L AH  Y AH 
वर्गको		W AH R AH  G AH K OH  
लुटपाट		L UH  T AH P AA  T AH 
लिनुस्।		L IH  N UH  S AH  
लाग्नुभएको		L AA  G AH  N UH  BA EH  K OH  
लाग्दैछु।		L AA  G AH  DH AH IH  CHA UH  
लडेर		L AH D EH  R AH 
लगेर		L AH G EH  R AH 
लगिदिन्छु।		L AH G IH  DH AH IH N AH  CHA UH  
लगाउँछु।		L AH G AA  UHN CHA UH  
लंदरी		L AH MDH AH R IH  
येनबाट		Y EH  N AH B AA  T AH 
यूनियन		Y UH  N IH  Y AH N AH 
म्यागजिन		M AH  Y AA  G AH JH IH  N AH 
मोल		M OH  L AH 
मिलेर		M IH  L EH  R AH 
मिलाइ		M IH  L AA  IH 
महिनावारी		M AH HH IH  N AA  W AH AA R AH IH 
मस्टार्ड		M AH S AH  T AA  R AH  D AH 
भोजनालयको		BA OH  JH AH N AA  L AH Y AH K AH OH 
भेट्नेछौं।		BA EH  T AH  N AH EH CHA AH UH  M
भेट्टाउनुहुनेछ।		BA EH  T AH  T AA  UH N UH  HH AH UH N AH EH CHA AH 
भेटें।		BA EH  T AH EH M
भाग्यो।		BA AA  G AH  Y OH  
भरिदिनुहुन्थ्यो		BA AH R IH  DH AH IH N UH  HH AH UH N AH  THA AH  Y OH  
ब्राण्डको		B AH  R AA  N AH  D AH K OH  
ब्युँझाइदिन		B AH  Y UH N JHA AA  IH DH IH  N AH 
बोलाऊछु।		B OH  L AA  UH CHA UH  
बोलाइदिनुहुन्थ्यो		B OH  L AA  IH DH IH  N UH  HH AH UH N AH  THA AH  Y AH OH 
बोर्डमा		B OH  R AH  D AH M AA  
बोकेको		B OH  K EH  K AH OH 
बेरमै		B EH  R AH M AH IH  
बुवा		B UH  W AA  
बुबालाई		B UH  B AA  L AH AA IH 
बुटिक		B UH  T IH  K AH 
बुझ्नु		B UH  JHA AH  N AH UH 
बुझेन।		B UH  JHA EH  N AH 
बीफ		B IH  PA AH 
बिल्डिंग		B IH  L AH  D AH IH MG AH 
बिदाको		B IH  DH AA  K OH  
बिताउन		B IH  TH AA  UH N AH 
बिचार।		B IH  CH AA  R AH 
बाहिरी		B AA  HH IH  R AH IH 
बस्नको		B AH S AH  N AH K OH  
बसाईमा		B AH S AA  IH M AH AA 
बनाइदिन		B AH N AA  IH DH IH  N AH 
बढ्नुहोस्।		B AH DA AH  N UH  HH OH  S AH  
फ्लाइटहरु		PA AH  L AA  IH T AH HH AH R UH  
फित्ता		PA IH  TH AH  TH AA  
फिट		PA IH  T AH 
फिक्का		PA IH  K AH  K AA  
फर्किन्छ।		PA AH R AH  K IH  N AH  CHA AH 
फर्काउने		PA AH R AH  K AA  UH N EH  
प्लेन		P AH  L EH  N AH 
प्रारम्भिक		P AH  R AA  R AH M AH  BA IH  K AH 
प्रस्थानको		P AH  R AH S AH  THA AA  N AH K OH  
प्रदर्शनको		P AH  R AH DH AH R AH  S AH N AH K OH  
प्रतीक्षा		P AH  R AH TH IH  K AH  S AA  
प्रतिघण्टा		P AH  R AH TH IH  GA AH N AH  T AA  
प्याड		P AH  Y AA  D AH 
पोल्नुस।		P OH  L AH  N UH  S AH 
पॉच		P AH CH AH 
पैसाबाट		P AH IH  S AA  B AH AA T AH 
पैतालीस		P AH IH  TH AA  L AH IH S AH 
पैंताला		P AH IH  MTH AA  L AH AA 
पेसा		P EH  S AA  
पुर्याईदिनुहुन्छ		P UH  R AH  Y AA  IH DH IH  N AH UH HH AH UH N AH  CHA AH 
पुग्नेछौं		P UH  G AH  N EH  CHA AH AH UH M
पुगिन्छ।		P UH  G IH  N AH  CHA AH 
पीडाको		P IH  D AA  K OH  
पिसाब		P IH  S AA  B AH 
पिउदा		P AH IW DH AA  
पाहुना		P AA  HH UH  N AH AA 
पासपोर्टको		P AA  S AH P OH  R AH  T AH K AH OH 
पाकने		P AA  K AH N EH  
पहेँलो		P AH HH EH N L OH  
पर्सी		P AH R AH  S IH  
पर्नेछ।		P AH R AH  N EH  CHA AH 
पर्खिनुहोला।		P AH R AH  KA IH  N UH  HH OH  L AA  
पचासको		P AH CH AA  S AH K OH  
नुहाउनेकोठामा		N UH  HH AA  UH N EH  K OH  TA AH AA M AH AA 
नीलोमा		N IH  L OH  M AA  
निस्क्यो।		N IH  S AH  K AH  Y OH  
निर्गम		N IH  R AH  G AH M AH 
नतीजा		N AH TH IH  JH AA  
धुलो		DHA UH  L OH  
धाराको		DHA AA  R AH AA K OH  
धन्यबाद		DHA AH N AH  Y AH B AA  DH AH 
द्रुतसेवा		DH AH  R UH  TH AH S EH  W AA  
दोहोरो		DH OH  HH AH OH R AH OH 
देखाइदिनुहोस्		DH EH  KA AA  IH DH IH  N UH  HH OH  S AH  
देउ।		DH AH EW 
दुवै		DH UH  W AH IH  
दिनुपर्छ।		DH IH  N UH  P AH R AH  CHA AH 
दिक्क		DH IH  K AH  K AH 
तिखो		TH IH  KA OH  
तापमान		TH AA  P AH M AH AA N AH 
तपाईंकोकोठा		TH AH P AA  IH MK OH  K AH OH TA AH AA 
तपाईँसँग		TH AH P AA  IHN S AHN G AH 
ड्राभीङ		D AH  R AA  BA IH  NG AH 
डिस्कोमा		D IH  S AH  K OH  M AA  
डिसेम्बर		D IH  S EH  M AH  B AH R AH 
डाइभिङ		D AA  IH BA IH  NG AH 
ठेलाहरु		TA EH  L AA  HH AH R UH  
ठीक्क		TA IH  K AH  K AH 
ठाउँहरुको		TA AA  UHN HH AH R UH  K OH  
ट्वाईलेट		T AH  W AA  IH L EH  T AH 
ट्रान्सफर।		T AH  R AA  N AH  S AH PA AH R AH 
ट्याक्सीसम्म		T AH  Y AA  K AH  S IH  S AH M AH  M AH 
ट्याक्स		T AH  Y AA  K AH  S AH 
टिप्स		T IH  P AH  S AH 
जोर्नी		JH OH  R AH  N IH  
जेट		JH EH  T AH 
जीले		JH IH  L EH  
जिउको		JH AH IW K OH  
जापान।		JH AA  P AH AA N AH 
जापानका		JH AA  P AH AA N AH K AH AA 
जापनी		JH AA  P AH N IH  
जानुहोस।		JH AA  N UH  HH OH  S AH 
जादै		JH AA  DH AH IH  
जाडोमा		JH AA  D OH  M AH AA 
जाउँ		JH AA  UHN 
जाँदैछ।		JH AA N DH AH IH  CHA AH 
जहाजको		JH AH HH AA  JH AH K OH  
जनसङ्ख्या		JH AH N AH S AH NG AH  KA AH  Y AA  
चौबिस		CH AH UH  B IH  S AH 
चेक ईन समय के हो		CH EH  K AH K AH EH 
चुहिरहेको		CH UH  HH IH  R AH HH EH  K OH  
चियामा		CH IH  Y AA  M AH AA 
चिनाउन		CH IH  N AA  UH N AH 
चित्त		CH IH  TH AH  TH AH 
चालकलाई		CH AA  L AH K AH L AH AA IH 
चालकको		CH AA  L AH K AH K OH  
चाईनिज		CH AA  IH N IH  JH AH 
चलचित्रहरू		CH AH L AH CH IH  TH AH  R AH HH AH R UH  
चलचित्रहरु		CH AH L AH CH IH  TH AH  R AH HH AH R UH  
चढेको		CH AH DA EH  K OH  
चक्कू		CH AH K AH  K UH  
घुँडा		GA UH N D AA  
गोरो		G OH  R AH OH 
गुणस्तरको		G UH  N AH S AH  TH AH R AH K OH  
गल्लीमा		G AH L AH  L IH  M AA  
गर्नुस।		G AH R AH  N UH  S AH 
गरेपछि		G AH R EH  P AH CHA IH  
खोसेर		KA OH  S EH  R AH 
खोजिदिनुहुन्छ		KA OH  JH IH  DH AH IH N UH  HH AH UH N AH  CHA AH 
खैरोमा		KA AH IH  R OH  M AA  
खेलाडी		KA EH  L AA  D IH  
खुल्छ।		KA UH  L AH  CHA AH 
खानालाई		KA AA  N AH AA L AH AA IH 
खानापछि		KA AA  N AH AA P AH CHA IH  
खको		KA AH K OH  
क्लिनिक		K AH  L IH  N AH IH K AH 
क्रिस्ट्मस।		K AH  R IH  S AH  T AH  M AH S AH 
क्योटोमा		K AH  Y OH  T AH OH M AA  
क्यारेटको		K AH  Y AA  R EH  T AH K OH  
क्याफे		K AH  Y AA  PA EH  
कोसँग		K OH  S AHN G AH 
केस		K EH  S AH 
केन्जी		K EH  N AH  JH IH  
केटीको		K EH  T IH  K OH  
केटिको		K EH  T IH  K OH  
केको		K EH  K OH  
कुनैपनि		K UH  N AH IH  P AH N AH IH 
कुना		K UH  N AA  
किनेको।		K IH  N EH  K OH  
किनारामा		K IH  N AA  R AH AA M AH AA 
कार्टून		K AA  R AH  T UH  N AH 
कारलाई		K AA  R AH L AH AA IH 
काट्यो।		K AA  T AH  Y OH  
काटि		K AA  T IH  
कागजहरु		K AA  G AH JH AH HH AH R UH  
काँधमा		K AA N DHA AH M AH AA 
कहिलै		K AH HH IH  L AH AH IH 
कलामा		K AH L AA  M AH AA 
कलको		K AH L AH K OH  
कम्बिनेसन		K AH M AH  B IH  N EH  S AH N AH 
कतिदिन		K AH TH IH  DH AH IH N AH 
कक्षामा		K AH K AH  S AA  M AH AA 
कंपनीलाई		K AH MP AH N IH  L AA  IH 
ओ।		OH 
एजेन्सी		EH JH EH  N AH  S IH  
एक्सपोजरको		EH K AH  S AH P OH  JH AH R AH K AH OH 
उपस्थित		UH P AH S AH  THA IH  TH AH 
उठेको		UH TA EH  K OH  
इलाका		IH L AA  K AH AA 
आवेदन		AA W EH  DH AH N AH 
आमालाई		AA M AA  L AH AA IH 
आउनुपर्छ।		AA UH N UH  P AH R AH  CHA AH 
आइपुग्छौं		AA IH P UH  G AH  CHA AH AH UH M
अस्वस्थ		AH S AH  W AH S AH  THA AH 
अस्पतालको		AH S AH  P AH TH AA  L AH K OH  
अरेन्ज		AH R EH  N AH  JH AH 
अरुकेही		AH R UH  K EH  HH IH  
अमेरीकन		AH M EH  R IH  K AH N AH 
अमेरिकाबाट		AH M EH  R IH  K AA  B AH AA T AH 
अपराह्न		AH P AH R AA  HH AH  N AH 
अझसम्म		AH JHA AH S AH M AH  M AH 
फ़्रेन्च		 R EH  N AH  CH AH 
हुन्दैन		HH UH  N AH  DH AH IH  N AH 
हुनेछौं।		HH UH  N EH  CHA AH AH UH M
हुनसक्छ		HH UH  N AH S AH K AH  CHA AH 
हुँन्छ।		HH UH N N AH  CHA AH 
हुँदैछ।		HH UH N DH AH IH  CHA AH 
स्वीटर		S AH  W IH  T AH R AH 
स्वीच		S AH  W IH  CH AH 
स्लट		S AH  L AH T AH 
स्याउको		S AH  Y AA  UH K OH  
स्याउ		S AH  Y AA  UH 
स्मारक		S AH  M AA  R AH K AH 
स्ट्याण्डमा		S AH  T AH  Y AA  N AH  D AH M AH AA 
स्कूलको		S AH  K UH  L AH K OH  
सोमवार		S OH  M AH W AA  R AH 
सेन्ट्राल		S EH  N AH  T AH  R AA  L AH 
सेन्टरमा		S EH  N AH  T AH R AH M AA  
सेन्टरको		S EH  N AH  T AH R AH K OH  
सेकेको		S EH  K AH EH K OH  
सुहाउँछ।		S UH  HH AA  UHN CHA AH 
सुरुवात		S UH  R AH UH W AA  TH AH 
सुन्दर।		S UH  N AH  DH AH R AH 
सिलसिलामा		S IH  L AH S AH IH L AA  M AH AA 
सिफारीश		S IH  PA AA  R AH IH S AH 
सिनेमा		S IH  N EH  M AA  
सिड्नी		S IH  D AH  N AH IH 
सिकारुको		S IH  K AA  R UH  K OH  
सिकाउने		S IH  K AA  UH N EH  
सामानहरु।		S AA  M AH AA N AH HH AH R UH  
साधे		S AA  DHA EH  
साटिदिनुहुन्थ्यो		S AA  T IH  DH AH IH N UH  HH AH UH N AH  THA AH  Y OH  
साचो		S AA  CH OH  
साईकल		S AA  IH K AH L AH 
समुद्रको		S AH M UH  DH AH  R AH K OH  
समात्नु		S AH M AA  TH AH  N UH  
सत्य		S AH TH AH  Y AH 
सत्ताईस		S AH TH AH  TH AA  IH S AH 
सडकबाट		S AH D AH K AH B AA  T AH 
सक्दैनौ।		S AH K AH  DH AH IH  N AH UH  
सकियेन।		S AH K IH  Y EH  N AH 
श्रेणीमा		S AH  R EH  N IH  M AA  
श्रीमतीको		S AH  R IH  M AH TH AH IH K OH  
शुरुमा		S UH  R AH UH M AA  
शिरानी		S IH  R AA  N AH IH 
शहरकोलागि		S AH HH AH R AH K OH  L AA  G IH  
शब्दको		S AH B AH  DH AH K OH  
व्यवहार		W AH  Y AH W AH HH AA  R AH 
वे		W EH  
वीजा		W IH  JH AA  
विभागको		W IH  BA AA  G AH K OH  
विन्ड		W IH  N AH  D AH 
लिमुजीन		L IH  M UH  JH AH IH N AH 
लिनुभएको		L IH  N UH  BA EH  K OH  
लागिसक्यो।		L AA  G IH  S AH K AH  Y OH  
लाउन्ड्री		L AA  UH N AH  D AH  R IH  
लाईसेन्स		L AA  IH S EH  N AH  S AH 
लहर		L AH HH AH R AH 
लन्दन		L AH N AH  DH AH N AH 
लगि		L AH G IH  
रोमान्चक		R OH  M AA  N AH  CH AH K AH 
रोममा		R OH  M AH M AA  
रोगको		R OH  G AH K AH OH 
रेसेर्भेसन		R EH  S AH EH R AH  BA AH EH S AH N AH 
रुक्न		R UH  K AH  N AH 
राजदुतावासमा		R AA  JH AH DH UH  TH AH AA W AH AA S AH M AH AA 
राखे		R AA  KA EH  
रहीरहन्छ		R AH HH IH  R AH HH AH N AH  CHA AH 
यात्रीको		Y AA  TH AH  R IH  K OH  
मोडेल		M OH  D EH  L AH 
मोडमा		M OH  D AH M AA  
मोटो		M OH  T AH OH 
मुक्ति		M UH  K AH  TH IH  
मीनेट		M IH  N EH  T AH 
मिलाएको		M IH  L AA  EH K OH  
मिनेरल		M IH  N EH  R AH L AH 
मार्गमा		M AA  R AH  G AH M AH AA 
मार्गबाट		M AA  R AH  G AH B AH AA T AH 
माछामा		M AA  CHA AH AA M AH AA 
महासागरको		M AH HH AA  S AH AA G AH R AH K OH  
महत्वपुर्ण		M AH HH AH TH AH  W AH P UH  R AH  N AH 
मसला		M AH S AH L AA  
मञ्च		M AH N AH  CH AH 
भेनिला		BA EH  N IH  L AA  
भेटौँ।		BA EH  T AH UH N 
भूमिगत		BA UH  M IH  G AH TH AH 
भी		BA IH  
भिन्दा		BA IH  N AH  DH AA  
भयानकसँग		BA AH Y AA  N AH K AH S AHN G AH 
भनेको।		BA AH N EH  K OH  
ब्लो		B AH  L OH  
बोस्टनमा		B OH  S AH  T AH N AH M AA  
बेस्सरी		B EH  S AH  S AH R IH  
बेलायतमा		B EH  L AA  Y AH TH AH M AH AA 
बुरैक		B UH  R AH IH  K AH 
बुट्टा		B UH  T AH  T AA  
बिजुली		B IH  JH UH  L AH IH 
बाल्न		B AA  L AH  N AH 
बसे		B AH S EH  
बसहरू		B AH S AH HH AH R UH  
बर्थ		B AH R AH  THA AH 
बनाइदिनुहोस्		B AH N AA  IH DH IH  N UH  HH OH  S AH  
बदल्नुहोस्।		B AH DH AH L AH  N UH  HH OH  S AH  
बट्टा		B AH T AH  T AA  
फोटोकपि		PA OH  T AH OH K AH P IH  
फुड		PA UH  D AH 
फिल्टर		PA IH  L AH  T AH R AH 
फिफ्थ		PA IH  PA AH  THA AH 
फाइदा		PA AA  IH DH AH AA 
फर्कनुपर्छ।		PA AH R AH  K AH N UH  P AH R AH  CHA AH 
प्लेटफर्मबाट		P AH  L EH  T AH PA AH R AH  M AH B AA  T AH 
प्लास्टिकको		P AH  L AA  S AH  T IH  K AH K OH  
प्रेम		P AH  R EH  M AH 
पौने		P AH UH  N EH  
पेट्रोलपम्प		P EH  T AH  R OH  L AH P AH M AH  P AH 
पुर्याइदिनुहुन्छ		P UH  R AH  Y AA  IH DH IH  N AH UH HH AH UH N AH  CHA AH 
पुर्ण		P UH  R AH  N AH 
पुनः		P UH  N AH 
पार्नुहोस्।		P AA  R AH  N UH  HH OH  S AH  
पानीले		P AA  N IH  L EH  
पानि		P AA  N IH  
पाचौं		P AA  CH AH UH  M
पाएँ		P AA  EHN 
पाउन्डमा		P AA  UH N AH  D AH M AH AA 
पाँचौँ		P AA N CH AH UH N 
पहिलाको		P AH HH IH  L AA  K OH  
पसलहरू		P AH S AH L AH HH AH R UH  
पर्सि		P AH R AH  S IH  
पर्यटकको		P AH R AH  Y AH T AH K AH K OH  
पर्		P AH R AH  
परिचित		P AH R IH  CH AH IH TH AH 
पप		P AH P AH 
पन्ध्रमा		P AH N AH  DHA AH  R AH M AA  
पन्चानब्बे		P AH N AH  CH AA  N AH B AH  B EH  
पदार्थको		P AH DH AA  R AH  THA AH K OH  
पठाइदिनुहोस्		P AH TA AA  IH DH IH  N UH  HH OH  S AH  
पछी।		P AH CHA IH  
पछाडीको		P AH CHA AA  D IH  K OH  
पचाउने		P AH CH AA  UH N EH  
नेगेटिभको		N EH  G AH EH T IH  BA AH K OH  
नुनिलो		N UH  N IH  L OH  
निवेदन		N IH  W EH  DH AH N AH 
निर्धारण		N IH  R AH  DHA AA  R AH N AH 
नियमहरु		N IH  Y AH M AH HH AH R UH  
निद्रा		N IH  DH AH  R AA  
नाजिक		N AA  JH IH  K AH 
नाकामुरा		N AA  K AH AA M UH  R AH AA 
नजीकको		N AH JH IH  K AH K OH  
धेरैनै		DHA EH  R AH IH  N AH AH IH 
धुँवा		DHA UH N W AA  
द्वारा		DH AH  W AA  R AH AA 
द्रेस्सिंग		DH AH  R EH  S AH  S IH  MG AH 
दिनसम्म		DH IH  N AH S AH M AH  M AH 
दिईन्छ		DH IH  IH N AH  CHA AH 
दाया		DH AA  Y AH AA 
दरबार		DH AH R AH B AA  R AH 
दमकल		DH AH M AH K AH L AH 
दध		DH AH DHA AH 
थीचे		THA IH  CH EH  
थाल्यो।		THA AA  L AH  Y OH  
थाकेको		THA AA  K EH  K OH  
त्यतिबेला		TH AH  Y AH TH IH  B EH  L AA  
तिरें।		TH IH  R EH  M
तल्लीन		TH AH L AH  L IH  N AH 
तर्फबाट।		TH AH R AH  PA AH B AA  T AH 
तपाइँलाई		TH AH P AA  IHN L AH AA IH 
डोभरको		D OH  BA AH R AH K AH OH 
डोभर		D OH  BA AH R AH 
डुङ्गा		D UH  NG AH  G AA  
डिजाइनमा		D IH  JH AA  IH N AH M AH AA 
डलरभन्दा		D AH L AH R AH BA AH N AH  DH AA  
ठोक्यो।		TA OH  K AH  Y AH OH 
ठाडो		TA AA  D OH  
ट्वाइलेटको		T AH  W AA  IH L EH  T AH K OH  
ट्रेनहरू		T AH  R EH  N AH HH AH R UH  
ट्रेनबाट		T AH  R EH  N AH B AA  T AH 
ट्रन्क		T AH  R AH N AH  K AH 
ट्रक		T AH  R AH K AH 
टोक्योमा		T OH  K AH  Y AH OH M AA  
टेलिग्रामको		T EH  L IH  G AH  R AA  M AH K OH  
टिकटले		T IH  K AH T AH L EH  
टाउकोमा		T AA  UH K OH  M AH AA 
टमाटर		T AH M AA  T AH R AH 
झोला।		JHA OH  L AA  
जुवा		JH UH  W AA  
जिम		JH IH  M AH 
जारि		JH AA  R IH  
जानाको		JH AA  N AH AA K OH  
जाँदैछौं।		JH AA N DH AH IH  CHA AH UH  M
जाँचीदिन		JH AA N CH IH  DH AH IH N AH 
जर्मन		JH AH R AH  M AH N AH 
जनसंख्या		JH AH N AH S AH MKA AH  Y AA  
छुट्याएर		CHA UH  T AH  Y AA  EH R AH 
छिरेको		CHA IH  R EH  K OH  
छानेको		CHA AA  N EH  K OH  
छमा		CHA AH M AA  
चौथौं		CH AH UH  THA AH AH UH M
चोर्यो।		CH OH  R AH  Y AH OH 
चोरलाई		CH OH  R AH L AA  IH 
चेकइन		CH EH  K IH  N AH 
चिलायो।		CH IH  L AA  Y OH  
चिरा		CH IH  R AA  
चिन्नुहुन्छ		CH IH  N AH  N UH  HH AH UH N AH  CHA AH 
चिजको		CH IH  JH AH K OH  
चाहिंदैन		CH AA  HH IH  MDH AH AH IH N AH 
चाहि		CH AA  HH IH  
चाहँदिन।		CH AA  HH AHN DH IH  N AH 
चाबी		CH AA  B IH  
चक्कुले		CH AH K AH  K UH  L EH  
घाँटीमा		GA AA N T IH  M AH AA 
घडीहरू		GA AH D IH  HH AH R UH  
ग्लफ		G AH  L AH PA AH 
ग्यालरी		G AH  Y AA  L AH R IH  
गोली		G OH  L IH  
गाडीहरु		G AA  D IH  HH AH R UH  
गर्नु।		G AH R AH  N UH  
गर्नुहोस््।		G AH R AH  N UH  HH OH  S AH   
गर्नुभएकोमा		G AH R AH  N UH  BA EH  K OH  M AA  
गर्छौ		G AH R AH  CHA AH UH  
गरेकै		G AH R EH  K AH IH  
गरुङ्गो		G AH R UH  NG AH  G OH  
गरिदिनुभएकोमा		G AH R IH  DH AH IH N UH  BA EH  K OH  M AA  
गतेको		G AH TH EH  K OH  
गत		G AH TH AH 
गणना		G AH N AH N AA  
खोजि		KA OH  JH IH  
खेलकूद		KA EH  L AH K UH  DH AH 
खुसीसाथ		KA UH  S IH  S AA  THA AH 
खिच्ने		KA IH  CH AH  N EH  
खाजाको		KA AA  JH AH AA K OH  
खरीद		KA AH R IH  DH AH 
खतरा		KA AH TH AH R AA  
क्लेम		K AH  L EH  M AH 
क्लबको		K AH  L AH B AH K OH  
क्रिपया		K AH  R IH  P AH Y AA  
कोरिदिन		K OH  R IH  DH AH IH N AH 
केकको		K EH  K AH K OH  
कुराएकोमा		K UH  R AA  EH K OH  M AH AA 
किनें।		K IH  N EH  M
किताबमा		K IH  TH AA  B AH M AH AA 
कार्यक्रमहरु		K AA  R AH  Y AH K AH  R AH M AH HH AH R UH  
कसैको		K AH S AH IH  K OH  
कम्पनिलाई		K AH M AH  P AH N IH  L AA  IH 
कब्जीयत		K AH B AH  JH IH  Y AH TH AH 
कनेक्सन		K AH N EH  K AH  S AH N AH 
कतिमा		K AH TH IH  M AA  
ओर्लनुपर्ने		OH R AH  L AH N UH  P AH R AH  N EH  
एबीसी		EH B IH  S AH IH 
एकपाँच		EH K AH P AA N CH AH 
उभिन		UH BA IH  N AH 
उदाहरणको		UH DH AA  HH AH R AH N AH K OH  
उत्साहित		UH TH AH  S AA  HH IH  TH AH 
उड्दै		UH D AH  DH AH IH  
उठाउनु		UH TA AA  UH N UH  
आन्तरिक		AA N AH  TH AH R IH  K AH 
आजै		AA JH AH IH  
आएपछि		AA EH P AH CHA IH  
आउनेछौं।		AA UH N EH  CHA AH UH  M
आउनुहुनेछ।		AA UH N UH  HH AH UH N EH  CHA AH 
आउनुभएकोले		AA UH N UH  BA EH  K OH  L AH EH 
आउछु।		AA UH CHA UH  
आउँदो		AA UHN DH OH  
आउँछु		AA UHN CHA UH  
अविस्वसनीय।		AH W IH  S AH  W AH S AH N AH IH Y AH 
अलिक		AH L IH  K AH 
अबको		AH B AH K OH  
अपच		AH P AH CH AH 
अन्त्य		AH N AH  TH AH  Y AH 
अनुमती		AH N UH  M AH TH IH  
अनुमतिपत्र		AH N UH  M AH TH IH  P AH TH AH  R AH 
अध्यारो		AH DHA AH  Y AA  R OH  
अध्ययनको		AH DHA AH  Y AH Y AH N AH K OH  
अध्ययन		AH DHA AH  Y AH Y AH N AH 
अण्डा।		AH N AH  D AA  
अङ्ग्रेजीमा		AH NG AH  G AH  R EH  JH IH  M AA  
हेरौं		HH EH  R AH UH  M
हेर		HH EH  R AH 
हुदैन		HH UH  DH AH IH  N AH 
हुँनुहुँन्छ।		HH UH N N AH UH HH AH UHN N AH  CHA AH 
हिजोदेखि।		HH IH  JH OH  DH EH  KA AH IH 
हिऊँ		HH AH IWN 
हाल्नु		HH AA  L AH  N UH  
हाई		HH AA  IH 
हाँकिरहेको		HH AA N K IH  R AH HH EH  K OH  
हवाईमार्गबाट		HH AH W AA  IH M AH AA R AH  G AH B AH AA T AH 
हवाइजहाजको		HH AH W AA  IH JH AH HH AH AA JH AH K OH  
हल्लेको		HH AH L AH  L EH  K OH  
स्यान्डविच्		S AH  Y AA  N AH  D AH W IH  CH AH  
स्यान		S AH  Y AA  N AH 
स्त्रीको		S AH  TH AH  R IH  K OH  
स्टाईल		S AH  T AA  IH L AH 
स्कूबा		S AH  K UH  B AA  
स्कि		S AH  K IH  
सोधपुछ		S OH  DHA AH P UH  CHA AH 
सोच्नेछु।		S OH  CH AH  N EH  CHA UH  
सुसी		S UH  S IH  
सुनेकोले		S UH  N EH  K OH  L AH EH 
सुनेकोछु।		S UH  N EH  K OH  CHA AH UH 
सुखद		S UH  KA AH DH AH 
सीमा		S IH  M AA  
सिएटल		S IH  EH T AH L AH 
सामानहरुलाई		S AA  M AH AA N AH HH AH R UH  L AH AA IH 
साटीदिनुहोस्।		S AA  T IH  DH AH IH N UH  HH OH  S AH  
साटिदिनुहोला।		S AA  T IH  DH AH IH N UH  HH OH  L AH AA 
सागसब्जीहरु		S AA  G AH S AH B AH  JH IH  HH AH R UH  
साके		S AA  K EH  
साँस		S AA N S AH 
साँचो।		S AA N CH OH  
सलादमा		S AH L AA  DH AH M AH AA 
सलादको		S AH L AA  DH AH K OH  
सम्लगन		S AH M AH  L AH G AH N AH 
सभा		S AH BA AA  
सच्चै		S AH CH AH  CH AH IH  
सकीन।		S AH K IH  N AH 
श्रीमतीलाई		S AH  R IH  M AH TH AH IH L AA  IH 
श्रिमती		S AH  R IH  M AH TH AH IH 
शेयर		S EH  Y AH R AH 
शुभकामना।		S UH  BA AH K AA  M AH N AH AA 
शटल		S AH T AH L AH 
शंका		S AH MK AA  
व्यापारको		W AH  Y AA  P AH AA R AH K OH  
विद्यार्थीको		W IH  DH AH  Y AA  R AH  THA AH IH K OH  
वाणिज्य		W AA  N IH  JH AH  Y AH 
लोस		L OH  S AH 
लेबल		L EH  B AH L AH 
लेख्नुपर्छ		L EH  KA AH  N UH  P AH R AH  CHA AH 
लुटिएँ।		L UH  T IH  EHN 
लीन		L IH  N AH 
लिएँ		L IH  EHN 
लान्छु।		L AA  N AH  CHA UH  
लन्डनको		L AH N AH  D AH N AH K OH  
लग्छ		L AH G AH  CHA AH 
लगी		L AH G IH  
रोलर		R OH  L AH R AH 
रोकी		R OH  K IH  
रूमहरु		R UH  M AH HH AH R AH UH 
राष्ट्रीय		R AA  S AH  T AH  R IH  Y AH 
रात्रीभ्रमण		R AA  TH AH  R IH  BA AH  R AH M AH N AH 
राखीदिनुहोस्।		R AA  KA IH  DH AH IH N UH  HH OH  S AH  
राखीदिनुहुन्थ्यो		R AA  KA IH  DH AH IH N UH  HH AH UH N AH  THA AH  Y OH  
रहनु		R AH HH AH N UH  
रहदानी		R AH HH AH DH AA  N IH  
रस		R AH S AH 
रमाउनु		R AH M AA  UH N UH  
रक्त		R AH K AH  TH AH 
योजस्तै		Y OH  JH AH S AH  TH AH IH  
यूनाइटेड		Y UH  N AA  IH T EH  D AH 
युनाईटेड		Y UH  N AA  IH T EH  D AH 
यिनीहरुको		Y IH  N AH IH HH AH R UH  K OH  
यान		Y AA  N AH 
यात्रा।		Y AA  TH AH  R AH AA 
यातायात		Y AA  TH AH AA Y AH AA TH AH 
यहा		Y AH HH AA  
यच		Y AH CH AH 
म्याट		M AH  Y AA  T AH 
मुर्ख		M UH  R AH  KA AH 
मालहरु		M AA  L AH HH AH R UH  
मार्गदर्शक		M AA  R AH  G AH DH AH R AH  S AH K AH 
मानिसको		M AA  N IH  S AH K OH  
माचिको		M AA  CH IH  K OH  
महिलाहरुको		M AH HH IH  L AA  HH AH R UH  K OH  
महिना।		M AH HH IH  N AA  
महानगरीय		M AH HH AA  N AH G AH R IH  Y AH 
मरीच		M AH R IH  CH AH 
मनपर्यो		M AH N AH P AH R AH  Y OH  
मद्दतको		M AH DH AH  DH AH TH AH K OH  
भोल्टेज		BA OH  L AH  T EH  JH AH 
भैसक्यो		BA AH IH  S AH K AH  Y OH  
भेतेरा		BA EH  TH AH EH R AA  
भेट्नु		BA EH  T AH  N UH  
भेट्टाएँ।		BA EH  T AH  T AA  EHN 
भेटघाटको		BA EH  T AH GA AA  T AH K OH  
भेगास		BA EH  G AA  S AH 
भुइमा		BA UH  IH M AA  
भुइँमुनिको		BA UH  IHN M AH UH N IH  K OH  
भिन्नता		BA IH  N AH  N AH TH AA  
भाइ		BA AA  IH 
भरोसक्यो।		BA AH R OH  S AH K AH  Y AH OH 
भरिसक्यो।		BA AH R IH  S AH K AH  Y OH  
भरिभराउ		BA AH R IH  BA AH R AA  UH 
भय		BA AH Y AH 
भन्सारको		BA AH N AH  S AA  R AH K OH  
भन्दै		BA AH N AH  DH AH IH  
भइसके।		BA IH  S AH K EH  
ब्रोसर		B AH  R OH  S AH R AH 
ब्रिज		B AH  R IH  JH AH 
ब्रशुर		B AH  R AH S UH  R AH 
ब्यूझाईदिनुहुन्छ		B AH  Y UH  JHA AA  IH DH IH  N AH UH HH AH UH N AH  CHA AH 
बोलेको।		B OH  L EH  K AH OH 
बोर्डिंगको		B OH  R AH  D IH  MG AH K AH OH 
बेहोस्		B EH  HH OH  S AH  
बेलुकिको		B EH  L UH  K IH  K OH  
बूटहरु		B UH  T AH HH AH R AH UH 
बिहे		B IH  HH EH  
बिल।		B IH  L AH 
बिलकुल		B IH  L AH K UH  L AH 
बिमानस्थलको		B IH  M AA  N AH S AH  THA AH L AH K OH  
बिद्यार्थीहरुको		B IH  DH AH  Y AA  R AH  THA AH IH HH AH R UH  K OH  
बिग्रीएको		B IH  G AH  R AH IH EH K OH  
बातो		B AA  TH OH  
बहत्तर		B AH HH AH TH AH  TH AH R AH 
बस्नुहोस्		B AH S AH  N UH  HH OH  S AH  
बस्छौं।		B AH S AH  CHA AH UH  M
बसिरहेको		B AH S IH  R AH HH EH  K OH  
बसाइ		B AH S AA  IH 
बन्दोबस्त		B AH N AH  DH OH  B AH S AH  TH AH 
बत्तीबाट		B AH TH AH  TH IH  B AA  T AH 
बजारको		B AH JH AA  R AH K OH  
फ्लास		PA AH  L AA  S AH 
फ्लाईट कुन हो		PA AH  L AA  IH T AH 
फ्रान्सको		PA AH  R AA  N AH  S AH K OH  
फलफुलको		PA AH L AH PA UH  L AH K OH  
फर्किनुपर्छ		PA AH R AH  K IH  N UH  P AH R AH  CHA AH 
फर्कनुहुनेछ		PA AH R AH  K AH N UH  HH AH UH N EH  CHA AH 
प्राचीन		P AH  R AA  CH IH  N AH 
प्रशिक्षक		P AH  R AH S IH  K AH  S AH K AH 
प्रदान		P AH  R AH DH AA  N AH 
प्रतिको		P AH  R AH TH IH  K OH  
पोर्टर		P OH  R AH  T AH R AH 
पोर्क		P OH  R AH  K AH 
पोइन्ट		P OH  IH N AH  T AH 
पुस्तिकाहरू		P UH  S AH  TH IH  K AA  HH AH R AH UH 
पुष्टिकारन		P UH  S AH  T IH  K AA  R AH N AH 
पुछ्न		P UH  CHA AH  N AH 
पुछिदिन		P UH  CHA IH  DH AH IH N AH 
पुग्नेछौं।		P UH  G AH  N EH  CHA AH AH UH M
पुग्नुपर्छ		P UH  G AH  N AH UH P AH R AH  CHA AH 
पिउँदिन।		P AH IWN DH IH  N AH 
पाहुँना		P AA  HH UH N N AH AA 
पासमा		P AA  S AH M AH AA 
पार्सलको		P AA  R AH  S AH L AH K OH  
पाठ		P AA  TA AH 
पाखुरामा		P AA  KA UH  R AH AA M AH AA 
पाँचसय		P AA N CH AH S AH Y AH 
परिबर्तन		P AH R IH  B AH R AH  TH AH N AH 
पथप्रदर्शक		P AH THA AH P AH  R AH DH AH R AH  S AH K AH 
पठाइदिनुहोला।		P AH TA AA  IH DH IH  N UH  HH OH  L AH AA 
पछिल्लो		P AH CHA IH  L AH  L OH  
निर्देशक		N IH  R AH  DH EH  S AH K AH 
निजी		N IH  JH AH IH 
नापिदिन्छु।		N AA  P IH  DH AH IH N AH  CHA UH  
नाच		N AA  CH AH 
नाइट		N AA  IH T AH 
नाँच्न		N AA N CH AH  N AH 
नराम्रो।		N AH R AA  M AH  R OH  
नराम्रोसँग		N AH R AA  M AH  R OH  S AHN G AH 
नमान्नुहोस्।		N AH M AA  N AH  N UH  HH OH  S AH  
नगर।		N AH G AH R AH 
नगरी		N AH G AH R IH  
धुलाएर		DHA UH  L AA  EH R AH 
दौडिन्छ		DH AH UH  D IH  N AH  CHA AH 
दे।		DH EH  
देखें।		DH EH  KA AH EH M
देखिनेकोठा		DH EH  KA IH  N AH EH K OH  TA AA  
देखाउनुहोस्		DH EH  KA AA  UH N UH  HH OH  S AH  
दुईबोतल		DH UH  IH B OH  TH AH L AH 
दिनुस्।		DH IH  N UH  S AH  
दिनका		DH IH  N AH K AA  
दायाँबाट		DH AA  Y AH AAN B AH AA T AH 
दाजुभाइ		DH AA  JH UH  BA AH AA IH 
दशका		DH AH S AH K AA  
थोरै।		THA OH  R AH IH  
थालेको		THA AA  L EH  K OH  
तेज		TH EH  JH AH 
तिनिहरु		TH IH  N AH IH HH AH R UH  
तास		TH AA  S AH 
तारिक		TH AA  R IH  K AH 
तार		TH AA  R AH 
तहको		TH AH HH AH K OH  
तरिकामा		TH AH R IH  K AA  M AH AA 
तपाईंबाट		TH AH P AA  IH MB AH AA T AH 
डोरी		D OH  R IH  
डाउनटाउनको		D AA  UH N AH T AH AA UH N AH K OH  
ठाउ		TA AA  UH 
ट्याबलेट		T AH  Y AA  B AH L EH  T AH 
टोइलेट		T OH  IH L EH  T AH 
टेलिफोनको		T EH  L IH  PA OH  N AH K AH OH 
टिकटहरू।		T IH  K AH T AH HH AH R UH  
टाईम्स		T AA  IH M AH  S AH 
टाइम		T AA  IH M AH 
टन्सिल		T AH N AH  S IH  L AH 
झिक्ने		JHA IH  K AH  N EH  
झार्न		JHA AA  R AH  N AH 
झर्यो।		JHA AH R AH  Y OH  
जोड		JH OH  D AH 
जानै		JH AA  N AH IH  
जाँदैछौ		JH AA N DH AH IH  CHA AH UH  
जाँड		JH AA N D AH 
जरुरि		JH AH R UH  R IH  
जबसम्म		JH AH B AH S AH M AH  M AH 
छोडीदिनुहोस्।		CHA OH  D IH  DH AH IH N UH  HH AH OH S AH  
छुट्टिएँ।		CHA UH  T AH  T IH  EHN 
छुटको		CHA UH  T AH K OH  
छिन।		CHA IH  N AH 
चिकन		CH IH  K AH N AH 
चारको		CH AA  R AH K OH  
चाप		CH AA  P AH 
चलाउनु		CH AH L AA  UH N UH  
चलाउँछु।		CH AH L AA  UHN CHA UH  
चक्लेट		CH AH K AH  L EH  T AH 
घोषणामा		GA OH  S AH N AA  M AH AA 
घाममा		GA AA  M AH M AH AA 
घरमा।		GA AH R AH M AA  
घंटा		GA AH MT AA  
गोल्डेन		G OH  L AH  D EH  N AH 
गोडामा		G OH  D AA  M AH AA 
गैरहेको		G AH IH  R AH HH EH  K OH  
गुणस्तर		G UH  N AH S AH  TH AH R AH 
गिफ्ट		G IH  PA AH  T AH 
गर्नैपर्छ।		G AH R AH  N AH IH  P AH R AH  CHA AH 
गर्नेछौं		G AH R AH  N EH  CHA AH UH  M
गर्नेछौँ।		G AH R AH  N EH  CHA AH UH N 
गर्दैहुनुहुन्छ।		G AH R AH  DH AH IH  HH UH  N AH UH HH AH UH N AH  CHA AH 
गर्दैछ		G AH R AH  DH AH IH  CHA AH 
गर्दिन		G AH R AH  DH IH  N AH 
गरेकोले		G AH R EH  K OH  L AH EH 
गरुं		G AH R UH  M
गरिसकेका		G AH R IH  S AH K EH  K AA  
गर		G AH R AH 
गन्ध		G AH N AH  DHA AH 
खोज्ने		KA OH  JH AH  N EH  
खेरि		KA EH  R IH  
खुल्लै		KA UH  L AH  L AH IH  
खुलै		KA UH  L AH IH  
खुलेन।		KA UH  L EH  N AH 
खुलेको		KA UH  L EH  K OH  
खुलाउने		KA UH  L AA  UH N EH  
खुब		KA UH  B AH 
खुट्टामा		KA UH  T AH  T AA  M AH AA 
खामहरु		KA AA  M AH HH AH R UH  
खानेकुराहरु		KA AA  N EH  K UH  R AH AA HH AH R AH UH 
खाजाहरू		KA AA  JH AH AA HH AH R UH  
खाऔं।		KA AA  AH UN M
खाँदा		KA AA N DH AH AA 
खतरनाक		KA AH TH AH R AH N AA  K AH 
क्यास		K AH  Y AA  S AH 
क्याशर		K AH  Y AA  S AH R AH 
क्यालोरी		K AH  Y AA  L OH  R IH  
कोरि		K OH  R IH  
कोडाक		K OH  D AA  K AH 
कोच		K OH  CH AH 
कृपया तातो चिया दिनुहोस्।		K AH R P AH Y AA  DH IH  N UH  HH OH  S AH  
कुक		K UH  K AH 
किनेर		K IH  N EH  R AH 
किनारमा		K IH  N AA  R AH M AH AA 
किताबको		K IH  TH AA  B AH K OH  
कारखाना		K AA  R AH KA AH AA N AH AA 
कानमा		K AA  N AH M AH AA 
काठको		K AA  TA AH K OH  
काटें।		K AA  T EH  M
काटेँ।		K AA  T EH N 
काँचै		K AA N CH AH IH  
कहिलेको		K AH HH IH  L EH  K OH  
कमीज		K AH M IH  JH AH 
कतिजति		K AH TH IH  JH AH TH AH IH 
औजारहरु		AH UN JH AA  R AH HH AH R UH  
ओरेन्ज		OH R EH  N AH  JH AH 
ओभरसिज		OH BA AH R AH S IH  JH AH 
एरिया		EH R IH  Y AA  
एबिसी		EH B IH  S AH IH 
एन्जलस		EH N AH  JH AH L AH S AH 
एण्ड		EH N AH  D AH 
एक्सपोजर		EH K AH  S AH P OH  JH AH R AH 
एकदम्मै		EH K AH DH AH M AH  M AH IH  
उसो		UH S OH  
उनिहरु		UH N IH  HH AH R UH  
उत्तेजित		UH TH AH  TH EH  JH IH  TH AH 
उत्तरी		UH TH AH  TH AH R IH  
इतो		IH TH OH  
इटालीयन		IH T AA  L IH  Y AH N AH 
आफैसंग		AA PA AH IH  S AH MG AH 
आपतकालीन		AA P AH TH AH K AA  L IH  N AH 
आठ।		AA TA AH 
आठबजे		AA TA AH B AH JH EH  
आउनुहुनेछ		AA UH N UH  HH AH UH N EH  CHA AH 
आउँछन्		AA UHN CHA AH N AH  
आई।		AA IH 
आईसक्रिम		AA IH S AH K AH  R IH  M AH 
आइरहन्छ।		AA IH R AH HH AH N AH  CHA AH 
आइपुगें।		AA IH P UH  G EH  M
अस्पतालामा		AH S AH  P AH TH AA  L AH AA M AH AA 
असल		AH S AH L AH 
अवस्थित		AH W AH S AH  THA IH  TH AH 
अर्थशास्त्र		AH R AH  THA AH S AA  S AH  TH AH  R AH 
अफ्नो		AH PA AH  N OH  
अपरेटर।		AH P AH R EH  T AH R AH 
अन्त्यमा		AH N AH  TH AH  Y AH M AA  
अन्तरराष्ट्रिय		AH N AH  TH AH R AH R AA  S AH  T AH  R IH  Y AH 
अण्डाहरु		AH N AH  D AA  HH AH R UH  
अड्डामा		AH D AH  D AA  M AH AA 
अचम्म		AH CH AH M AH  M AH 
अगाडीनै		AH G AA  D IH  N AH AH IH 
अँग्रेज		AHN G AH  R EH  JH AH 
अ		AH 
