म		M AH 
यो		Y AH OH 
छ		CHA AH 
कृपया		K AH R P AH Y AH AA 
मलाई		M AH L AH AA IH 
कि		K AH IH 
के		K AH EH 
मेरो		M AH EH R AH OH 
छ।		CHA AH 
चाहन्छु।		CH AH AA HH AH N  CHA AH UH 
लागि		L AH AA G AH IH 
हो		HH AH OH 
कति		K AH TH AH IH 
तपाईं		TH AH P AH AA IH M
कहाँ		K AH HH AH AAN 
दिनुहोस्।		DH AH IH N AH UH HH AH OH S  
एउटा		EH UH T AH AA 
गर्न		G AH R  N AH 
होला		HH AH OH L AH AA 
हो।		HH AH OH 
मैले		M AH AH IH L AH EH 
यहाँ		Y AH HH AH AAN 
त्यो		TH  Y AH OH 
तपाईंको		TH AH P AH AA IH MK AH OH 
केही		K AH EH HH AH IH 
र		R AH 
एक		EH K AH 
छैन।		CHA AH AH IH N AH 
माफ		M AH AA PA AH 
सक्छु		S AH K  CHA AH UH 
हुन्छ		HH AH UH N  CHA AH 
की		K AH IH 
धेरै		DHA AH EH R AH AH IH 
कुन		K AH UH N AH 
तपाईंलाई		TH AH P AH AA IH ML AH AA IH 
राम्रो		R AH AA M  R AH OH 
कुनै		K AH UH N AH AH IH 
सँग		S AHN G AH 
कस्तो		K AH S  TH AH OH 
सक्नुहुन्थ्यो		S AH K  N AH UH HH AH UH N  THA  Y AH OH 
समय		S AH M AH Y AH 
हामी		HH AH AA M AH IH 
धन्यवाद।		DHA AH N  Y AH W AH AA DH AH 
दुई		DH AH UH IH 
सक्नुहुन्छ		S AH K  N AH UH HH AH UH N  CHA AH 
पनि		P AH N AH IH 
भएको		BA AH EH K AH OH 
पर्छ		P AH R  CHA AH 
कोठा		K AH OH TA AH AA 
अर्को		AH R  K AH OH 
सकिन्छ		S AH K AH IH N  CHA AH 
लाग्छ		L AH AA G  CHA AH 
हजुर		HH AH JH AH UH R AH 
छन्		CHA AH N  
फोन		PA AH OH N AH 
खाना		KA AH AA N AH AA 
को		K AH OH 
सिट		S AH IH T AH 
जान		JH AH AA N AH 
अहिले		AH HH AH IH L AH EH 
लिन		L AH IH N AH 
कहिले		K AH HH AH IH L AH EH 
छु।		CHA AH UH 
जाने		JH AH AA N AH EH 
नम्बर		N AH M  B AH R AH 
दिन		DH AH IH N AH 
टिकट		T AH IH K AH T AH 
तपाईंले		TH AH P AH AA IH ML AH EH 
कसरी		K AH S AH R AH IH 
भयो।		BA AH Y AH OH 
बजे		B AH JH AH EH 
हजुर।		HH AH JH AH UH R AH 
बस		B AH S AH 
हुन्छ।		HH AH UH N  CHA AH 
जापानी		JH AH AA P AH AA N AH IH 
सम्म		S AH M  M AH 
हेर्न		HH AH EH R  N AH 
आज		AA JH AH 
नाम		N AH AA M AH 
सबै		S AH B AH AH IH 
पाउन		P AH AA UH N AH 
गर्नुहोस्।		G AH R  N AH UH HH AH OH S  
तीन		TH AH IH N AH 
गर्नुहोला।		G AH R  N AH UH HH AH OH L AH AA 
चेक		CH AH EH K AH 
डलर		D AH L AH R AH 
गर्ने		G AH R  N AH EH 
कुरा		K AH UH R AH AA 
त्यहाँ		TH  Y AH HH AH AAN 
सामान		S AH AA M AH AA N AH 
अलि		AH L AH IH 
मिल्छ		M AH IH L  CHA AH 
चाहनुहुन्छ		CH AH AA HH AH N AH UH HH AH UH N  CHA AH 
ठाउँ		TA AH AA UHN 
प्रयोग		P  R AH Y AH OH G AH 
यसलाई		Y AH S AH L AH AA IH 
गर्छु।		G AH R  CHA AH UH 
तर		TH AH R AH 
पैसा		P AH AH IH S AH AA 
जस्तो		JH AH S  TH AH OH 
शुल्क		S AH UH L  K AH 
गर्नुहुन्छ		G AH R  N AH UH HH AH UH N  CHA AH 
लाग्यो।		L AH AA G  Y AH OH 
पाँच		P AH AAN CH AH 
पाउनसक्छु		P AH AA UH N AH S AH K  CHA AH UH 
अनि		AH N AH IH 
गरेको		G AH R AH EH K AH OH 
ठिक		TA AH IH K AH 
ए		EH 
यसको		Y AH S AH K AH OH 
गर्नुहोला		G AH R  N AH UH HH AH OH L AH AA 
हुनुहुन्छ		HH AH UH N AH UH HH AH UH N  CHA AH 
भन्न		BA AH N  N AH 
ठीक		TA AH IH K AH 
होइन		HH AH OH IH N AH 
पानी		P AH AA N AH IH 
थाहा		THA AH AA HH AH AA 
सय		S AH Y AH 
कार्ड		K AH AA R  D AH 
केहि		K AH EH HH AH IH 
भने		BA AH N AH EH 
झोला		JHA AH OH L AH AA 
छन्।		CHA AH N  
मसँग		M AH S AHN G AH 
तपाईंसँग		TH AH P AH AA IH MS AHN G AH 
किन्न		K AH IH N  N AH 
होइन।		HH AH OH IH N AH 
थियो।		THA AH IH Y AH OH 
गाडी		G AH AA D AH IH 
गर्नसक्छु		G AH R  N AH S AH K  CHA AH UH 
त		TH AH 
भयो		BA AH Y AH OH 
भन्दा		BA AH N  DH AH AA 
संग		S AH MG AH 
मन		M AH N AH 
न।		N AH 
तपाई		TH AH P AH AA IH 
सात		S AH AA TH AH 
फिर्ता		PA AH IH R  TH AH AA 
अझै		AH JHA AH AH IH 
पाइन्छ		P AH AA IH N  CHA AH 
जापानमा		JH AH AA P AH AA N AH M AH AA 
दिनुहोला।		DH AH IH N AH UH HH AH OH L AH AA 
आफ्नो		AA PA  N AH OH 
सबैभन्दा		S AH B AH AH IH BA AH N  DH AH AA 
होला।		HH AH OH L AH AA 
लागी		L AH AA G AH IH 
धुम्रपान		DHA AH UH M  R AH P AH AA N AH 
ट्याक्सी		T  Y AH AA K  S AH IH 
चार		CH AH AA R AH 
कफी		K AH PA AH IH 
बाट		B AH AA T AH 
भित्र		BA AH IH TH  R AH 
छैन		CHA AH AH IH N AH 
गर्नुहोस्		G AH R  N AH UH HH AH OH S  
रिजर्भेसन		R AH IH JH AH R  BA AH EH S AH N AH 
पसल		P AH S AH L AH 
पठाउन		P AH TA AH AA UH N AH 
अरु		AH R AH UH 
भोलि		BA AH OH L AH IH 
मा		M AH AA 
सानो		S AH AA N AH OH 
जापान		JH AH AA P AH AA N AH 
कतिबजे		K AH TH AH IH B AH JH AH EH 
ट्रेन		T  R AH EH N AH 
काम		K AH AA M AH 
फोटो		PA AH OH T AH OH 
देखाउनुहोस्।		DH AH EH KA AH AA UH N AH UH HH AH OH S  
फेरी		PA AH EH R AH IH 
हाम्रो		HH AH AA M  R AH OH 
नै		N AH AH IH 
मद्दत		M AH DH  DH AH TH AH 
खान		KA AH AA N AH 
कार		K AH AA R AH 
दिनुहुन्छ		DH AH IH N AH UH HH AH UH N  CHA AH 
फेरि		PA AH EH R AH IH 
कल		K AH L AH 
भाडामा		BA AH AA D AH AA M AH AA 
एकदम		EH K AH DH AH M AH 
आठ		AA TA AH 
दश		DH AH S AH 
पछि		P AH CHA AH IH 
फ्लाईट		PA  L AH AA IH T AH 
बाटो		B AH AA T AH OH 
हुने		HH AH UH N AH EH 
बताईदिनुहुन्छ		B AH TH AH AA IH DH AH IH N AH UH HH AH UH N  CHA AH 
मात्र		M AH AA TH  R AH 
थियो		THA AH IH Y AH OH 
रसिद		R AH S AH IH DH AH 
औषधि		AH UN S AH DHA AH IH 
क्रेडिट		K  R AH EH D AH IH T AH 
वटा		W AH T AH AA 
पक्का		P AH K  K AH AA 
पर्छ।		P AH R  CHA AH 
थिएँ।		THA AH IH EHN 
ठुलो		TA AH UH L AH OH 
गरिदिनुहोस्।		G AH R AH IH DH AH IH N AH UH HH AH OH S  
बाहिर		B AH AA HH AH IH R AH 
नजिकै		N AH JH AH IH K AH AH IH 
बस्न		B AH S  N AH 
लाग्छ।		L AH AA G  CHA AH 
कोठामा		K AH OH TA AH AA M AH AA 
यसमा		Y AH S AH M AH AA 
हुँ।		HH AH UHN 
लिएर		L AH IH EH R AH 
गरेर		G AH R AH EH R AH 
अर्डर		AH R  D AH R AH 
साट्न		S AH AA T  N AH 
जति		JH AH TH AH IH 
भए		BA AH EH 
छिटो		CHA AH IH T AH OH 
साँचो		S AH AAN CH AH OH 
सस्तो		S AH S  TH AH OH 
खालको		KA AH AA L AH K AH OH 
नमस्ते।		N AH M AH S  TH AH EH 
आएको		AA EH K AH OH 
स्टेशन		S  T AH EH S AH N AH 
मिनेट		M AH IH N AH EH T AH 
सकिन्थ्यो		S AH K AH IH N  THA  Y AH OH 
बिहान		B AH IH HH AH AA N AH 
कर		K AH R AH 
लामो		L AH AA M AH OH 
लागि।		L AH AA G AH IH 
दिनको		DH AH IH N AH K AH OH 
दुख्छ।		DH AH UH KA  CHA AH 
खाली		KA AH AA L AH IH 
भ्रमण		BA  R AH M AH N AH 
जे		JH AH EH 
शौचालय		S AH AH UH CH AH AA L AH Y AH 
नौ		N AH AH UH 
गर्नु		G AH R  N AH UH 
बारेमा		B AH AA R AH EH M AH AA 
जना		JH AH N AH AA 
अझ		AH JHA AH 
रेस्टुरेन्ट		R AH EH S  T AH UH R AH EH N  T AH 
कोठाको		K AH OH TA AH AA K AH OH 
तिर्न		TH AH IH R  N AH 
रिजर्भ		R AH IH JH AH R  BA AH 
लागेको		L AH AA G AH EH K AH OH 
भाषा		BA AH AA S AH AA 
हुनुहुन्छ।		HH AH UH N AH UH HH AH UH N  CHA AH 
बन्द		B AH N  DH AH 
गरिदिनुहुन्छ		G AH R AH IH DH AH IH N AH UH HH AH UH N  CHA AH 
टाढा		T AH AA DA AH AA 
चाहिं		CH AH AA HH AH IH M
दुखेको		DH AH UH KA AH EH K AH OH 
हामीले		HH AH AA M AH IH L AH EH 
रहेछ।		R AH HH AH EH CHA AH 
महसूस		M AH HH AH S AH UH S AH 
पुग्न		P AH UH G  N AH 
दिनुहोस।		DH AH IH N AH UH HH AH OH S AH 
आजको		AA JH AH K AH OH 
बेला		B AH EH L AH AA 
टेबल		T AH EH B AH L AH 
होटल		HH AH OH T AH L AH 
होटेल		HH AH OH T AH EH L AH 
देखि		DH AH EH KA AH IH 
शून्य		S AH UH N  Y AH 
दुईवटा		DH AH UH IH W AH T AH AA 
विचारमा		W AH IH CH AH AA R AH M AH AA 
लिन्छु।		L AH IH N  CHA AH UH 
यस		Y AH S AH 
सक्नुहुन्छ।		S AH K  N AH UH HH AH UH N  CHA AH 
लुगा		L AH UH G AH AA 
तयार		TH AH Y AH AA R AH 
बुक		B AH UH K AH 
लिनुहोस्।		L AH IH N AH UH HH AH OH S  
यहाँबाट		Y AH HH AH AAN B AH AA T AH 
तिमीलाई		TH AH IH M AH IH L AH AA IH 
भेट्न		BA AH EH T  N AH 
यहाँको		Y AH HH AH AAN K AH OH 
अब		AH B AH 
जान्छ		JH AH AA N  CHA AH 
पत्र		P AH TH  R AH 
जनाको		JH AH N AH AA K AH OH 
चाहिन्छ		CH AH AA HH AH IH N  CHA AH 
हेर्नसक्छु		HH AH EH R  N AH S AH K  CHA AH UH 
चाहिँ		CH AH AA HH AH IHN 
वाइन		W AH AA IH N AH 
मलाइ		M AH L AH AA IH 
पटक		P AH T AH K AH 
समयमा		S AH M AH Y AH M AH AA 
नराम्रो		N AH R AH AA M  R AH OH 
पचास		P AH CH AH AA S AH 
शुभ		S AH UH BA AH 
पेट		P AH EH T AH 
नक्शा		N AH K  S AH AA 
छुट		CHA AH UH T AH 
टाउको		T AH AA UH K AH OH 
गलत		G AH L AH TH AH 
बियर		B AH IH Y AH R AH 
प्रकारको		P  R AH K AH AA R AH K AH OH 
नयाँ		N AH Y AH AAN 
नजिकको		N AH JH AH IH K AH K AH OH 
त्यति		TH  Y AH TH AH IH 
छु		CHA AH UH 
हरायो।		HH AH R AH AA Y AH OH 
पहिलो		P AH HH AH IH L AH OH 
जानकारी		JH AH AA N AH K AH AA R AH IH 
सेवा		S AH EH W AH AA 
बिहानको		B AH IH HH AH AA N AH K AH OH 
उडान		UH D AH AA N AH 
यात्रा		Y AH AA TH  R AH AA 
समस्या		S AH M AH S  Y AH AA 
भाडा		BA AH AA D AH AA 
मनपर्छ		M AH N AH P AH R  CHA AH 
तपाईंसंग		TH AH P AH AA IH MS AH MG AH 
डाक्टर		D AH AA K  T AH R AH 
घर		GA AH R AH 
ठूलो		TA AH UH L AH OH 
बीस		B AH IH S AH 
कतै		K AH TH AH AH IH 
हुलाक		HH AH UH L AH AA K AH 
दिनुहोस्		DH AH IH N AH UH HH AH OH S  
आउनुहोस्।		AA UH N AH UH HH AH OH S  
बनेको		B AH N AH EH K AH OH 
लिनसक्छु		L AH IH N AH S AH K  CHA AH UH 
रेल		R AH EH L AH 
रिजर्भेशन		R AH IH JH AH R  BA AH EH S AH N AH 
चिया		CH AH IH Y AH AA 
सक्छौं		S AH K  CHA AH AH UH M
धन्यबाद।		DHA AH N  Y AH B AH AA DH AH 
चिसो		CH AH IH S AH OH 
औषधी		AH UN S AH DHA AH IH 
ऊ		UH 
भन्ने		BA AH N  N AH EH 
पर्ने		P AH R  N AH EH 
तातो		TH AH AA TH AH OH 
कता		K AH TH AH AA 
उपहार		UH P AH HH AH AA R AH 
कार्यालय		K AH AA R  Y AH AA L AH Y AH 
सिटमा		S AH IH T AH M AH AA 
गर्नुपर्छ		G AH R  N AH UH P AH R  CHA AH 
किन		K AH IH N AH 
हामीसँग		HH AH AA M AH IH S AHN G AH 
जापानको		JH AH AA P AH AA N AH K AH OH 
गर्दा		G AH R  DH AH AA 
तपाइ		TH AH P AH AA IH 
खुद्रा		KA AH UH DH  R AH AA 
आउन		AA UH N AH 
पासपोर्ट		P AH AA S AH P AH OH R  T AH 
लगाएर		L AH G AH AA EH R AH 
गरि		G AH R AH IH 
होटेलमा		HH AH OH T AH EH L AH M AH AA 
देखाउन		DH AH EH KA AH AA UH N AH 
वा		W AH AA 
परिवर्तन		P AH R AH IH W AH R  TH AH N AH 
ट्राभल		T  R AH AA BA AH L AH 
चाहनुहुन्छ।		CH AH AA HH AH N AH UH HH AH UH N  CHA AH 
खोज्दैछु।		KA AH OH JH  DH AH AH IH CHA AH UH 
अलिकति		AH L AH IH K AH TH AH IH 
यी		Y AH IH 
नजिक		N AH JH AH IH K AH 
ल्याईदिन		L  Y AH AA IH DH AH IH N AH 
रहेको		R AH HH AH EH K AH OH 
रमाइलो		R AH M AH AA IH L AH OH 
तिर		TH AH IH R AH 
डलरको		D AH L AH R AH K AH OH 
गराउन		G AH R AH AA UH N AH 
तरिका		TH AH R AH IH K AH AA 
खेल्न		KA AH EH L  N AH 
यदि		Y AH DH AH IH 
बोल्ने		B AH OH L  N AH EH 
बिल		B AH IH L AH 
घोषणा		GA AH OH S AH N AH AA 
अगाडी		AH G AH AA D AH IH 
मासु		M AH AA S AH UH 
चाहिन्छ।		CH AH AA HH AH IH N  CHA AH 
भनेर		BA AH N AH EH R AH 
खाने		KA AH AA N AH EH 
कपाल		K AH P AH AA L AH 
कतिवटा		K AH TH AH IH W AH T AH AA 
हवाई		HH AH W AH AA IH 
सर।		S AH R AH 
समावेश		S AH M AH AA W AH EH S AH 
मान्छे		M AH AA N  CHA AH EH 
सुरक्षित		S AH UH R AH K  S AH IH TH AH 
खानाको		KA AH AA N AH AA K AH OH 
सल्लाह		S AH L  L AH AA HH AH 
सफा		S AH PA AH AA 
राति		R AH AA TH AH IH 
राख्न		R AH AA KA  N AH 
माछा		M AH AA CHA AH AA 
यसले		Y AH S AH L AH EH 
फिल्म		PA AH IH L  M AH 
ढिलो		DA AH IH L AH OH 
आभारी		AA BA AH AA R AH IH 
हुन्थ्यो		HH AH UH N  THA  Y AH OH 
सकिन।		S AH K AH IH N AH 
बेला।		B AH EH L AH AA 
मनपर्छ।		M AH N AH P AH R  CHA AH 
ठेगाना		TA AH EH G AH AA N AH AA 
शुरु		S AH UH R AH UH 
भेटेर		BA AH EH T AH EH R AH 
नि।		N AH IH 
चढ्न		CH AH DA  N AH 
तपाईको		TH AH P AH AA IH K AH OH 
स्टप		S  T AH P AH 
सामानहरु		S AH AA M AH AA N AH HH AH R AH UH 
जानको		JH AH AA N AH K AH OH 
चलाउन		CH AH L AH AA UH N AH 
हुन		HH AH UH N AH 
सहयोग		S AH HH AH Y AH OH G AH 
सक्दिनँ।		S AH K  DH AH IH N AHN 
नमस्कार		N AH M AH S  K AH AA R AH 
जानुहोस्।		JH AH AA N AH UH HH AH OH S  
अथवा		AH THA AH W AH AA 
सम्पर्क		S AH M  P AH R  K AH 
पार्क		P AH AA R  K AH 
टोकियो		T AH OH K AH IH Y AH OH 
कतिपर्छ		K AH TH AH IH P AH R  CHA AH 
सुझाव		S AH UH JHA AH AA W AH 
पिउन		P AH IH UH N AH 
पक्कै		P AH K  K AH AH IH 
धन्यवाद		DHA AH N  Y AH W AH AA DH AH 
मुख्य		M AH UH KA  Y AH 
हामीलाई		HH AH AA M AH IH L AH AA IH 
बिमा		B AH IH M AH AA 
त्यस्तो		TH  Y AH S  TH AH OH 
त्यसको		TH  Y AH S AH K AH OH 
तिन		TH AH IH N AH 
जान्छु।		JH AH AA N  CHA AH UH 
दस		DH AH S AH 
तीस		TH AH IH S AH 
चीज		CH AH IH JH AH 
गर्नको		G AH R  N AH K AH OH 
विशेष		W AH IH S AH EH S AH 
स्टेक		S  T AH EH K AH 
भनेको		BA AH N AH EH K AH OH 
टिकेट		T AH IH K AH EH T AH 
सुरु		S AH UH R AH UH 
पन्ध्र		P AH N  DHA  R AH 
माथि		M AH AA THA AH IH 
बुकिङ		B AH UH K AH IH NG AH 
आउट		AA UH T AH 
श्रीमान्		S  R AH IH M AH AA N  
उहाँ		UH HH AH AAN 
मेनु		M AH EH N AH UH 
एकदमै		EH K AH DH AH M AH AH IH 
फारम		PA AH AA R AH M AH 
प्रहरी		P  R AH HH AH R AH IH 
भन्नुहोस्।		BA AH N  N AH UH HH AH OH S  
रोक्नुहोस्।		R AH OH K  N AH UH HH AH OH S  
रद्द		R AH DH  DH AH 
कोही		K AH OH HH AH IH 
है।		HH AH AH IH 
सक्छू		S AH K  CHA AH UH 
रातिको		R AH AA TH AH IH K AH OH 
सेन्ट		S AH EH N  T AH 
जस्तै		JH AH S  TH AH AH IH 
स्थानीय		S  THA AH AA N AH IH Y AH 
सीट		S AH IH T AH 
म्याडम		M  Y AH AA D AH M AH 
जाँच		JH AH AAN CH AH 
मिठो		M AH IH TA AH OH 
ब्याग		B  Y AH AA G AH 
तपाईलाई		TH AH P AH AA IH L AH AA IH 
हराएँ।		HH AH R AH AA EHN 
झ्याल		JHA  Y AH AA L AH 
उसलाई		UH S AH L AH AA IH 
अहँ		AH HH AHN 
निकै		N AH IH K AH AH IH 
थोरै		THA AH OH R AH AH IH 
डलरमा		D AH L AH R AH M AH AA 
उपलब्ध		UH P AH L AH B  DHA AH 
माफी		M AH AA PA AH IH 
छुट्छ		CHA AH UH T  CHA AH 
हजुरलाई		HH AH JH AH UH R AH L AH AA IH 
महँगो		M AH HH AHN G AH OH 
कम		K AH M AH 
इन		IH N AH 
अगाडि		AH G AH AA D AH IH 
तल		TH AH L AH 
घण्टा		GA AH N  T AH AA 
यता		Y AH TH AH AA 
मिल्ने		M AH IH L  N AH EH 
नमस्ते		N AH M AH S  TH AH EH 
करिब		K AH R AH IH B AH 
आधा		AA DHA AH AA 
शहरको		S AH HH AH R AH K AH OH 
गेट		G AH EH T AH 
सन्चो		S AH N  CH AH OH 
देखाइदिनु		DH AH EH KA AH AA IH DH AH IH N AH UH 
गर्दै		G AH R  DH AH AH IH 
किसीमको		K AH IH S AH IH M AH K AH OH 
साँच्चै		S AH AAN CH  CH AH AH IH 
लाग्दैन।		L AH AA G  DH AH AH IH N AH 
रातो		R AH AA TH AH OH 
नमस्कार।		N AH M AH S  K AH AA R AH 
खुल्छ		KA AH UH L  CHA AH 
साथी		S AH AA THA AH IH 
मौसम		M AH AH UH S AH M AH 
भएन।		BA AH EH N AH 
फरक		PA AH R AH K AH 
पहिले		P AH HH AH IH L AH EH 
निषेधित		N AH IH S AH EH DHA AH IH TH AH 
बजेको		B AH JH AH EH K AH OH 
होटलमा		HH AH OH T AH L AH M AH AA 
छोटो		CHA AH OH T AH OH 
दाँत		DH AH AAN TH AH 
काउन्टर		K AH AA UH N  T AH R AH 
ढोका		DA AH OH K AH AA 
कहाँबाट		K AH HH AH AAN B AH AA T AH 
हुन्।		HH AH UH N  
मूल्य		M AH UH L  Y AH 
त्यसैले		TH  Y AH S AH AH IH L AH EH 
जुत्ता		JH AH UH TH  TH AH AA 
जी		JH AH IH 
चिज		CH AH IH JH AH 
आउँछ		AA UHN CHA AH 
साइज		S AH AA IH JH AH 
विचार		W AH IH CH AH AA R AH 
वरिपरी		W AH R AH IH P AH R AH IH 
लाई		L AH AA IH 
झोलाहरु		JHA AH OH L AH AA HH AH R AH UH 
पनि।		P AH N AH IH 
नंबर		N AH MB AH R AH 
दिने		DH AH IH N AH EH 
चोरी		CH AH OH R AH IH 
खेल		KA AH EH L AH 
अंग्रेजी		AH MG  R AH EH JH AH IH 
बिग्रियो।		B AH IH G  R AH IH Y AH OH 
पर्यटक		P AH R  Y AH T AH K AH 
छोड्न		CHA AH OH D  N AH 
राख्नुहोस्।		R AH AA KA  N AH UH HH AH OH S  
सुन्दर		S AH UH N  DH AH R AH 
येन		Y AH EH N AH 
भोली		BA AH OH L AH IH 
न्यू		N  Y AH UH 
उनी		UH N AH IH 
ठीकै		TA AH IH K AH AH IH 
ठिकै		TA AH IH K AH AH IH 
आउने		AA UH N AH EH 
रातको		R AH AA TH AH K AH OH 
पहिला		P AH HH AH IH L AH AA 
पर्खनुहोस्।		P AH R  KA AH N AH UH HH AH OH S  
दिन्छु।		DH AH IH N  CHA AH UH 
डलर।		D AH L AH R AH 
गरें।		G AH R AH EH M
कोहि		K AH OH HH AH IH 
नि		N AH IH 
त्यसोभए		TH  Y AH S AH OH BA AH EH 
खिच्न		KA AH IH CH  N AH 
आउँछु।		AA UHN CHA AH UH 
हवस्		HH AH W AH S  
राम्रो।		R AH AA M  R AH OH 
गिलास		G AH IH L AH AA S AH 
अति		AH TH AH IH 
लिन्छ		L AH IH N  CHA AH 
घडी		GA AH D AH IH 
यस्तो		Y AH S  TH AH OH 
हजार		HH AH JH AH AA R AH 
सुटकेस		S AH UH T AH K AH EH S AH 
खुशी		KA AH UH S AH IH 
हुनेछ।		HH AH UH N AH EH CHA AH 
दिनुहुन्थ्यो		DH AH IH N AH UH HH AH UH N  THA  Y AH OH 
तुरुन्तै		TH AH UH R AH UH N  TH AH AH IH 
उ		UH 
दुर्घटना		DH AH UH R  GA AH T AH N AH AA 
चलचित्र		CH AH L AH CH AH IH TH  R AH 
किसिमको		K AH IH S AH IH M AH K AH OH 
कार्यक्रम		K AH AA R  Y AH K  R AH M AH 
हात		HH AH AA TH AH 
बोतल		B AH OH TH AH L AH 
पैसाको		P AH AH IH S AH AA K AH OH 
लिइएको		L AH IH IH EH K AH OH 
रात		R AH AA TH AH 
प्रस्थान		P  R AH S  THA AH AA N AH 
ज्वरो		JH  W AH R AH OH 
गर्दैछु।		G AH R  DH AH AH IH CHA AH UH 
सिधा		S AH IH DHA AH AA 
योजना		Y AH OH JH AH N AH AA 
भनिदिनुहोला।		BA AH N AH IH DH AH IH N AH UH HH AH OH L AH AA 
ठाउँमा		TA AH AA UHN M AH AA 
नक्सा		N AH K  S AH AA 
टेलिफोन		T AH EH L AH IH PA AH OH N AH 
राती		R AH AA TH AH IH 
बोल्दैछु।		B AH OH L  DH AH AH IH CHA AH UH 
पर्ला		P AH R  L AH AA 
चोरियो।		CH AH OH R AH IH Y AH OH 
नाप		N AH AA P AH 
गरिदिनुहोला।		G AH R AH IH DH AH IH N AH UH HH AH OH L AH AA 
सर्भिस		S AH R  BA AH IH S AH 
रुम		R AH UH M AH 
बोलाइदिनुहोस्।		B AH OH L AH AA IH DH AH IH N AH UH HH AH OH S  
जहाज		JH AH HH AH AA JH AH 
लिनुहोला।		L AH IH N AH UH HH AH OH L AH AA 
सेन्ट्रल		S AH EH N  T  R AH L AH 
लिनुहुन्छ		L AH IH N AH UH HH AH UH N  CHA AH 
देखिन्छ।		DH AH EH KA AH IH N  CHA AH 
टोकियोमा		T AH OH K AH IH Y AH OH M AH AA 
अन्तिम		AH N  TH AH IH M AH 
ले		L AH EH 
बस्नुहुन्छ		B AH S  N AH UH HH AH UH N  CHA AH 
अस्पताल		AH S  P AH TH AH AA L AH 
रिपोर्ट		R AH IH P AH OH R  T AH 
यस्तै		Y AH S  TH AH AH IH 
क्यामेरा		K  Y AH AA M AH EH R AH AA 
बायाँ		B AH AA Y AH AAN 
देखाईदिनुहुन्छ		DH AH EH KA AH AA IH DH AH IH N AH UH HH AH UH N  CHA AH 
टेनिस		T AH EH N AH IH S AH 
एकछिन		EH K AH CHA AH IH N AH 
दोस्रो		DH AH OH S  R AH OH 
तपाईँको		TH AH P AH AA IHN K AH OH 
उनान्सय		UH N AH AA N  S AH Y AH 
राहदानी		R AH AA HH AH DH AH AA N AH IH 
त।		TH AH 
सही		S AH HH AH IH 
लिने		L AH IH N AH EH 
बिरामी		B AH IH R AH AA M AH IH 
नगद		N AH G AH DH AH 
गरिएको		G AH R AH IH EH K AH OH 
सेतो		S AH EH TH AH OH 
सक्छु।		S AH K  CHA AH UH 
रक्सी		R AH K  S AH IH 
बाँकी		B AH AAN K AH IH 
चार्ज		CH AH AA R  JH AH 
सलाद		S AH L AH AA DH AH 
सक्ने		S AH K  N AH EH 
लगभग		L AH G AH BA AH G AH 
सन्देश		S AH N  DH AH EH S AH 
बाटोको		B AH AA T AH OH K AH OH 
पिउने		P AH IH UH N AH EH 
साढे		S AH AA DA AH EH 
भएँ।		BA AH EHN 
जम्मा		JH AH M  M AH AA 
साँझ		S AH AAN JHA AH 
मेरा		M AH EH R AH AA 
भन्सार		BA AH N  S AH AA R AH 
चाहियो।		CH AH AA HH AH IH Y AH OH 
एकैछिन		EH K AH AH IH CHA AH IH N AH 
साइजको		S AH AA IH JH AH K AH OH 
प्रभात।		P  R AH BA AH AA TH AH 
प्रति		P  R AH TH AH IH 
त्यसलाई		TH  Y AH S AH L AH AA IH 
जारी		JH AH AA R AH IH 
घरमा		GA AH R AH M AH AA 
खबर		KA AH B AH R AH 
है		HH AH AH IH 
बसेको		B AH S AH EH K AH OH 
चाहन्छौं।		CH AH AA HH AH N  CHA AH AH UH M
गर्नुपर्छ।		G AH R  N AH UH P AH R  CHA AH 
गरिदिन		G AH R AH IH DH AH IH N AH 
महसुस		M AH HH AH S AH UH S AH 
बिस्तारै		B AH IH S  TH AH AA R AH AH IH 
कसैलाई		K AH S AH AH IH L AH AA IH 
बस्छु।		B AH S  CHA AH UH 
यहॉ		Y AH HH AH 
बढी		B AH DA AH IH 
ढिला		DA AH IH L AH AA 
खुशि		KA AH UH S AH IH 
आराम		AA R AH AA M AH 
सामानको		S AH AA M AH AA N AH K AH OH 
लोकप्रिय		L AH OH K AH P  R AH IH Y AH 
भवन		BA AH W AH N AH 
झ्यालको		JHA  Y AH AA L AH K AH OH 
बैंक		B AH AH IH MK AH 
जुस		JH AH UH S AH 
खोल्न		KA AH OH L  N AH 
हरेक		HH AH R AH EH K AH 
सिफारिस		S AH IH PA AH AA R AH IH S AH 
समुन्द्री		S AH M AH UH N  DH  R AH IH 
जानु		JH AH AA N AH UH 
घुम्नको		GA AH UH M  N AH K AH OH 
पर्यो।		P AH R  Y AH OH 
नोट		N AH OH T AH 
जाडो		JH AH AA D AH OH 
अनुसार		AH N AH UH S AH AA R AH 
स्टेसन		S  T AH EH S AH N AH 
सम्म।		S AH M  M AH 
विमानस्थल		W AH IH M AH AA N AH S  THA AH L AH 
लिनुहोस्		L AH IH N AH UH HH AH OH S  
बनाउन		B AH N AH AA UH N AH 
केवल		K AH EH W AH L AH 
हल्का		HH AH L  K AH AA 
सक्नु		S AH K  N AH UH 
सँगै		S AHN G AH AH IH 
पुग्ने		P AH UH G  N AH EH 
दिउँसो		DH AH IH UHN S AH OH 
बस्ने		B AH S  N AH EH 
निश्चयनै।		N AH IH S  CH AH Y AH N AH AH IH 
टिकटहरु		T AH IH K AH T AH HH AH R AH UH 
जानुहोला।		JH AH AA N AH UH HH AH OH L AH AA 
एक्सप्रेस		EH K  S AH P  R AH EH S AH 
माग्छु।		M AH AA G  CHA AH UH 
नम्बरको		N AH M  B AH R AH K AH OH 
सक्दिन।		S AH K  DH AH IH N AH 
संगै		S AH MG AH AH IH 
दिवा		DH AH IH W AH AA 
ट्रेनमा		T  R AH EH N AH M AH AA 
हिजो		HH AH IH JH AH OH 
बोल्न		B AH OH L  N AH 
बिशेष		B AH IH S AH EH S AH 
खुसी		KA AH UH S AH IH 
आफैले		AA PA AH AH IH L AH EH 
भोक		BA AH OH K AH 
छोडें।		CHA AH OH D AH EH M
मदत		M AH DH AH TH AH 
टूर		T AH UH R AH 
जाँदै		JH AH AAN DH AH AH IH 
किन्ने		K AH IH N  N AH EH 
किनमेल		K AH IH N AH M AH EH L AH 
पठाइदिनुहोस्।		P AH TA AH AA IH DH AH IH N AH UH HH AH OH S  
गर्नुभयो		G AH R  N AH UH BA AH Y AH OH 
उहाँलाई		UH HH AH AAN L AH AA IH 
अभिवादन।		AH BA AH IH W AH AA DH AH N AH 
व्यक्ति		W  Y AH K  TH AH IH 
मर्मत		M AH R  M AH TH AH 
क्रिम		K  R AH IH M AH 
हिंडेर		HH AH IH MD AH EH R AH 
राम्रोसँग		R AH AA M  R AH OH S AHN G AH 
रंग		R AH MG AH 
तल्लामा		TH AH L  L AH AA M AH AA 
कसैले		K AH S AH AH IH L AH EH 
होटेलको		HH AH OH T AH EH L AH K AH OH 
सिंगल		S AH IH MG AH L AH 
समयको		S AH M AH Y AH K AH OH 
यात्राको		Y AH AA TH  R AH AA K AH OH 
भाग		BA AH AA G AH 
बाकस		B AH AA K AH S AH 
चुरोट		CH AH UH R AH OH T AH 
आवश्यक		AA W AH S  Y AH K AH 
अतिरिक्त		AH TH AH IH R AH IH K  TH AH 
चल्छ		CH AH L  CHA AH 
गए		G AH EH 
चोटि		CH AH OH T AH IH 
खैरो		KA AH AH IH R AH OH 
आशा		AA S AH AA 
अली		AH L AH IH 
दृश्य		DH AH R S  Y AH 
गएर		G AH EH R AH 
हरियो		HH AH R AH IH Y AH OH 
पसलमा		P AH S AH L AH M AH AA 
किताब		K AH IH TH AH AA B AH 
एकजना		EH K AH JH AH N AH AA 
स्वीकार		S  W AH IH K AH AA R AH 
शहर		S AH HH AH R AH 
भाँडा		BA AH AAN D AH AA 
बि		B AH IH 
पास		P AH AA S AH 
कुर्न		K AH UH R  N AH 
अफिस		AH PA AH IH S AH 
राम्ररी		R AH AA M  R AH R AH IH 
जानुहुन्छ		JH AH AA N AH UH HH AH UH N  CHA AH 
चढ्ने		CH AH DA  N AH EH 
कालो		K AH AA L AH OH 
रंगको		R AH MG AH K AH OH 
फेर्न		PA AH EH R  N AH 
परिचय		P AH R AH IH CH AH Y AH 
हिल्टन		HH AH IH L  T AH N AH 
लाइन		L AH AA IH N AH 
लस		L AH S AH 
पर्स		P AH R  S AH 
न		N AH 
तालिका		TH AH AA L AH IH K AH AA 
कुनामा		K AH UH N AH AA M AH AA 
एलर्जी		EH L AH R  JH AH IH 
सजिलो		S AH JH AH IH L AH OH 
सकिनँ।		S AH K AH IH N AHN 
बाह्र		B AH AA HH  R AH 
कसले		K AH S AH L AH EH 
दायाँ		DH AH AA Y AH AAN 
तपाईले		TH AH P AH AA IH L AH EH 
डबल		D AH B AH L AH 
गरौ		G AH R AH AH UH 
हप्ता		HH AH P  TH AH AA 
सम्मको		S AH M  M AH K AH OH 
मेल		M AH EH L AH 
भाँडामा		BA AH AAN D AH AA M AH AA 
पखाला		P AH KA AH AA L AH AA 
गरी		G AH R AH IH 
अघि		AH GA AH IH 
अप्ठ्यारो		AH P  TA  Y AH AA R AH OH 
संलग्न		S AH ML AH G  N AH 
लगाउने		L AH G AH AA UH N AH EH 
भनिदिनुहुन्छ		BA AH N AH IH DH AH IH N AH UH HH AH UH N  CHA AH 
पोको		P AH OH K AH OH 
तिनीहरु		TH AH IH N AH IH HH AH R AH UH 
टेबुल		T AH EH B AH UH L AH 
गराएको		G AH R AH AA EH K AH OH 
उसले		UH S AH L AH EH 
आयो।		AA Y AH OH 
सिटहरु		S AH IH T AH HH AH R AH UH 
लागी।		L AH AA G AH IH 
मिलाउन		M AH IH L AH AA UH N AH 
ट्राभलर्स		T  R AH AA BA AH L AH R  S AH 
मूल्यमा		M AH UH L  Y AH M AH AA 
पाईन्छ		P AH AA IH N  CHA AH 
कप		K AH P AH 
बोलाउन		B AH OH L AH AA UH N AH 
पुरानो		P AH UH R AH AA N AH OH 
नजिकैको		N AH JH AH IH K AH AH IH K AH OH 
दर		DH AH R AH 
साथीलाई		S AH AA THA AH IH L AH AA IH 
रोक्छ		R AH OH K  CHA AH 
फ्लाइट		PA  L AH AA IH T AH 
प्रख्यात		P  R AH KA  Y AH AA TH AH 
पुस्तिका		P AH UH S  TH AH IH K AH AA 
गरिदिनु		G AH R AH IH DH AH IH N AH UH 
ओहो		OH HH AH OH 
रातीको		R AH AA TH AH IH K AH OH 
मुल्य		M AH UH L  Y AH 
परेको		P AH R AH EH K AH OH 
पत्रिका		P AH TH  R AH IH K AH AA 
पछाडि		P AH CHA AH AA D AH IH 
नम्बरमा		N AH M  B AH R AH M AH AA 
दिनु		DH AH IH N AH UH 
छालाको		CHA AH AA L AH AA K AH OH 
खानुहुन्छ		KA AH AA N AH UH HH AH UH N  CHA AH 
होस्।		HH AH OH S  
सहितको		S AH HH AH IH TH AH K AH OH 
सम्ममा		S AH M  M AH M AH AA 
भेटौंला।		BA AH EH T AH AH UH ML AH AA 
भइहाल्छ		BA AH IH HH AH AA L  CHA AH 
तिर्छु।		TH AH IH R  CHA AH UH 
जुन		JH AH UH N AH 
अण्डा		AH N  D AH AA 
हेर्दैछु।		HH AH EH R  DH AH AH IH CHA AH UH 
सि		S AH IH 
पाउरोटी		P AH AA UH R AH OH T AH IH 
तिम्रो		TH AH IH M  R AH OH 
एघार		EH GA AH AA R AH 
हराएको		HH AH R AH AA EH K AH OH 
बोस्टन		B AH OH S  T AH N AH 
बुकिङ्ग		B AH UH K AH IH NG  G AH 
फ्रेन्च		PA  R AH EH N  CH AH 
खोजिरहेको		KA AH OH JH AH IH R AH HH AH EH K AH OH 
कस्ता		K AH S  TH AH AA 
कलेक्ट		K AH L AH EH K  T AH 
मनपर्दैन।		M AH N AH P AH R  DH AH AH IH N AH 
बोलाईदिनुहुन्छ		B AH OH L AH AA IH DH AH IH N AH UH HH AH UH N  CHA AH 
बेच्ने		B AH EH CH  N AH EH 
बिक्री		B AH IH K  R AH IH 
दुखि		DH AH UH KA AH IH 
राख्नुहोस।		R AH AA KA  N AH UH HH AH OH S AH 
ट्यांकि		T  Y AH AA MK AH IH 
उसको		UH S AH K AH OH 
अग्लो		AH G  L AH OH 
सुन्तलाको		S AH UH N  TH AH L AH AA K AH OH 
सिफारिश		S AH IH PA AH AA R AH IH S AH 
वर्ष		W AH R  S AH 
पेट्रोल		P AH EH T  R AH OH L AH 
गल्ती		G AH L  TH AH IH 
अवश्य		AH W AH S  Y AH 
हप्ताको		HH AH P  TH AH AA K AH OH 
साईज		S AH AA IH JH AH 
रुपमा		R AH UH P AH M AH AA 
बोलाउनुहोस।		B AH OH L AH AA UH N AH UH HH AH OH S AH 
जानुपर्छ		JH AH AA N AH UH P AH R  CHA AH 
चाहिंदैन।		CH AH AA HH AH IH MDH AH AH IH N AH 
खुजुरा		KA AH UH JH AH UH R AH AA 
सीधा		S AH IH DHA AH AA 
यति		Y AH TH AH IH 
भएर		BA AH EH R AH 
पनी		P AH N AH IH 
नक्सामा		N AH K  S AH AA M AH AA 
उसोभए		UH S AH OH BA AH EH 
होटलको		HH AH OH T AH L AH K AH OH 
विनिमय		W AH IH N AH IH M AH Y AH 
तपाईंसित		TH AH P AH AA IH MS AH IH TH AH 
तपाईँ		TH AH P AH AA IHN 
चाहन्छु		CH AH AA HH AH N  CHA AH UH 
चाँडै		CH AH AAN D AH AH IH 
कोक		K AH OH K AH 
कार्डले		K AH AA R  D AH L AH EH 
कती		K AH TH AH IH 
राखिदिन		R AH AA KA AH IH DH AH IH N AH 
बोल्नुहोस्।		B AH OH L  N AH UH HH AH OH S  
ठेगानामा		TA AH EH G AH AA N AH AA M AH AA 
जाँदा		JH AH AAN DH AH AA 
कोट		K AH OH T AH 
उद्देश्य		UH DH  DH AH EH S  Y AH 
सवारी		S AH W AH AA R AH IH 
मोड्नुहोस्।		M AH OH D  N AH UH HH AH OH S  
दुइ		DH AH UH IH 
थिए।		THA AH IH EH 
गाइड		G AH AA IH D AH 
आनन्द		AA N AH N  DH AH 
अन्य		AH N  Y AH 
हुनेछ		HH AH UH N AH EH CHA AH 
सिकाउनुहोस्।		S AH IH K AH AA UH N AH UH HH AH OH S  
रंगमा		R AH MG AH M AH AA 
त्यसो		TH  Y AH S AH OH 
घाँटी		GA AH AAN T AH IH 
सहर		S AH HH AH R AH 
संग्रहालय		S AH MG  R AH HH AH AA L AH Y AH 
यिनीहरु		Y AH IH N AH IH HH AH R AH UH 
बीमा		B AH IH M AH AA 
बिदा		B AH IH DH AH AA 
बिग्रेको		B AH IH G  R AH EH K AH OH 
पुन		P AH UH N AH 
पर्दैन।		P AH R  DH AH AH IH N AH 
नुहाउने		N AH UH HH AH AA UH N AH EH 
निर्णय		N AH IH R  N AH Y AH 
ब्याट्री		B  Y AH AA T  R AH IH 
फ्याक्स		PA  Y AH AA K  S AH 
देशबाट		DH AH EH S AH B AH AA T AH 
दाहिने		DH AH AA HH AH IH N AH EH 
चिन्ह		CH AH IH N  HH AH 
चिन्ता		CH AH IH N  TH AH AA 
गरौँ।		G AH R AH AH UHN 
सन्चै		S AH N  CH AH AH IH 
रगत		R AH G AH TH AH 
भनि		BA AH N AH IH 
प्रायजसो		P  R AH AA Y AH JH AH S AH OH 
नौं		N AH AH UH M
ति		TH AH IH 
छौं।		CHA AH AH UH M
चाहन्छौँ।		CH AH AA HH AH N  CHA AH AH UHN 
खाजा		KA AH AA JH AH AA 
कपडा		K AH P AH D AH AA 
अमेरिकी		AH M AH EH R AH IH K AH IH 
साटिदिनुहुन्छ		S AH AA T AH IH DH AH IH N AH UH HH AH UH N  CHA AH 
पठाईदिन		P AH TA AH AA IH DH AH IH N AH 
दिनमा		DH AH IH N AH M AH AA 
दर्ता		DH AH R  TH AH AA 
तेस्रो		TH AH EH S  R AH OH 
चानचुन		CH AH AA N AH CH AH UH N AH 
एकछीन		EH K AH CHA AH IH N AH 
सहित		S AH HH AH IH TH AH 
भर्नाशुल्क		BA AH R  N AH AA S AH UH L  K AH 
बाँकि		B AH AAN K AH IH 
चक्कर		CH AH K  K AH R AH 
गर्नुहोस।		G AH R  N AH UH HH AH OH S AH 
गएको		G AH EH K AH OH 
खोल्नुहोस्।		KA AH OH L  N AH UH HH AH OH S  
खोज्दै		KA AH OH JH  DH AH AH IH 
खालका		KA AH AA L AH K AH AA 
आउँनुभयो		AA UHN N AH UH BA AH Y AH OH 
लगाउन		L AH G AH AA UH N AH 
मगाएको		M AH G AH AA EH K AH OH 
भेट्टाउन		BA AH EH T  T AH AA UH N AH 
बोलाउनुहोस्।		B AH OH L AH AA UH N AH UH HH AH OH S  
दृश्यावलोकन		DH AH R S  Y AH AA W AH L AH OH K AH N AH 
तिर्ने		TH AH IH R  N AH EH 
तिर्नुपर्छ		TH AH IH R  N AH UH P AH R  CHA AH 
ठाऊँ		TA AH AA UHN 
गर्नुभएको		G AH R  N AH UH BA AH EH K AH OH 
कसलाई		K AH S AH L AH AA IH 
राख्ने		R AH AA KA  N AH EH 
टाई		T AH AA IH 
घुम्न		GA AH UH M  N AH 
आफै		AA PA AH AH IH 
हुन्		HH AH UH N  
हल्ला		HH AH L  L AH AA 
शान्त		S AH AA N  TH AH 
व्यक्तिगत		W  Y AH K  TH AH IH G AH TH AH 
राखेको		R AH AA KA AH EH K AH OH 
भ्रमणमा		BA  R AH M AH N AH M AH AA 
बिर्सेछु।		B AH IH R  S AH EH CHA AH UH 
बारे		B AH AA R AH EH 
पछाडी		P AH CHA AH AA D AH IH 
कम्बल		K AH M  B AH L AH 
उहाँको		UH HH AH AAN K AH OH 
हिसाब		HH AH IH S AH AA B AH 
सम्लग्न		S AH M  L AH G  N AH 
व्यस्त		W  Y AH S  TH AH 
लैजान		L AH AH IH JH AH AA N AH 
ध्यान		DHA  Y AH AA N AH 
टिकटको		T AH IH K AH T AH K AH OH 
चिठी		CH AH IH TA AH IH 
गाह्रो		G AH AA HH  R AH OH 
खुल्ला		KA AH UH L  L AH AA 
भन्नुहुन्छ		BA AH N  N AH UH HH AH UH N  CHA AH 
बत्ती		B AH TH  TH AH IH 
पेय		P AH EH Y AH 
पदार्थ		P AH DH AH AA R  THA AH 
तेल		TH AH EH L AH 
हरायो		HH AH R AH AA Y AH OH 
वरिपरि		W AH R AH IH P AH R AH IH 
मुद्रा		M AH UH DH  R AH AA 
भन्नुहोस्		BA AH N  N AH UH HH AH OH S  
त्यस्तै		TH  Y AH S  TH AH AH IH 
वान्ता		W AH AA N  TH AH AA 
रोल		R AH OH L AH 
योर्क		Y AH OH R  K AH 
पाउँछ		P AH AA UHN CHA AH 
चिठ्ठी		CH AH IH TA  TA AH IH 
गल्फ		G AH L  PA AH 
क्लब		K  L AH B AH 
केन्द्र		K AH EH N  DH  R AH 
अमेरिकामा		AH M AH EH R AH IH K AH AA M AH AA 
हुनुपर्छ।		HH AH UH N AH UH P AH R  CHA AH 
माफ गर्नुहोस्।		M AH AA PA AH 
बोलाई		B AH OH L AH AA IH 
प्रहरीलाई		P  R AH HH AH R AH IH L AH AA IH 
प्रवेश		P  R AH W AH EH S AH 
नास्ता		N AH AA S  TH AH AA 
सबवे		S AH B AH W AH EH 
लगिदिनुहुन्छ		L AH G AH IH DH AH IH N AH UH HH AH UH N  CHA AH 
रमणीय		R AH M AH N AH IH Y AH 
मिनेटमा		M AH IH N AH EH T AH M AH AA 
बस्नु		B AH S  N AH UH 
बजेसम्म		B AH JH AH EH S AH M  M AH 
बचाऊ।		B AH CH AH AA UH 
प्रतिशत		P  R AH TH AH IH S AH TH AH 
नक्शामा		N AH K  S AH AA M AH AA 
ती		TH AH IH 
टिकेटहरु		T AH IH K AH EH T AH HH AH R AH UH 
जानुपर्छ।		JH AH AA N AH UH P AH R  CHA AH 
छाला		CHA AH AA L AH AA 
चोट		CH AH OH T AH 
अस्पतालमा		AH S  P AH TH AH AA L AH M AH AA 
अवश्य।		AH W AH S  Y AH 
हेर्छु।		HH AH EH R  CHA AH UH 
साह्रै		S AH AA HH  R AH AH IH 
लुगाहरु		L AH UH G AH AA HH AH R AH UH 
मेसेज		M AH EH S AH EH JH AH 
मात्र।		M AH AA TH  R AH 
बोक्ने		B AH OH K  N AH EH 
बेलुकाको		B AH EH L AH UH K AH AA K AH OH 
बार		B AH AA R AH 
बसमा		B AH S AH M AH AA 
बजे।		B AH JH AH EH 
प्रदर्शन		P  R AH DH AH R  S AH N AH 
दिउँसोको		DH AH IH UHN S AH OH K AH OH 
जापानबाट		JH AH AA P AH AA N AH B AH AA T AH 
खुकुलो		KA AH UH K AH UH L AH OH 
साथीको		S AH AA THA AH IH K AH OH 
रोक्ने		R AH OH K  N AH EH 
मात्रै		M AH AA TH  R AH AH IH 
पक्का।		P AH K  K AH AA 
एक्लै		EH K  L AH AH IH 
हैन		HH AH AH IH N AH 
स्की		S  K AH IH 
सी		S AH IH 
सहमत		S AH HH AH M AH TH AH 
सर्न		S AH R  N AH 
भ्रमणको		BA  R AH M AH N AH K AH OH 
भोलिको		BA AH OH L AH IH K AH OH 
बज्यो		B AH JH  Y AH OH 
नभएको		N AH BA AH EH K AH OH 
झोलामा		JHA AH OH L AH AA M AH AA 
जाम		JH AH AA M AH 
उनि		UH N AH IH 
अत्यन्त		AH TH  Y AH N  TH AH 
हालेको		HH AH AA L AH EH K AH OH 
सहरको		S AH HH AH R AH K AH OH 
लिनु		L AH IH N AH UH 
बुझ्दिन।		B AH UH JHA  DH AH IH N AH 
पायो		P AH AA Y AH OH 
ज्याकेट		JH  Y AH AA K AH EH T AH 
जरुरी		JH AH R AH UH R AH IH 
चिनी		CH AH IH N AH IH 
काँटा		K AH AAN T AH AA 
लिफ्ट		L AH IH PA  T AH 
रूम		R AH UH M AH 
रिजर्बेसन		R AH IH JH AH R  B AH EH S AH N AH 
रमाईलो		R AH M AH AA IH L AH OH 
मे		M AH EH 
फ्लाईटमा		PA  L AH AA IH T AH M AH AA 
टोकियोको		T AH OH K AH IH Y AH OH K AH OH 
चोटी		CH AH OH T AH IH 
गर्मी		G AH R  M AH IH 
अनुरोध		AH N AH UH R AH OH DHA AH 
हुन्थ्यो।		HH AH UH N  THA  Y AH OH 
स्टोर		S  T AH OH R AH 
स्टेशनमा		S  T AH EH S AH N AH M AH AA 
बोलाईदिनुहोस्।		B AH OH L AH AA IH DH AH IH N AH UH HH AH OH S  
बिचमा		B AH IH CH AH M AH AA 
बर्ष		B AH R  S AH 
पछी		P AH CHA AH IH 
छिन्।		CHA AH IH N  
गर्छ		G AH R  CHA AH 
खर्च		KA AH R  CH AH 
आउँछ।		AA UHN CHA AH 
हेर्ने		HH AH EH R  N AH EH 
सायद		S AH AA Y AH DH AH 
मोडिनुहोस्।		M AH OH D AH IH N AH UH HH AH OH S  
ब्लक		B  L AH K AH 
निलो		N AH IH L AH OH 
टायर		T AH AA Y AH R AH 
ओपेरा		OH P AH EH R AH AA 
प्रमाणपत्र		P  R AH M AH AA N AH P AH TH  R AH 
पम्प		P AH M  P AH 
चोर।		CH AH OH R AH 
गाईको		G AH AA IH K AH OH 
आउनुहुन्छ		AA UH N AH UH HH AH UH N  CHA AH 
हस्ताक्षर		HH AH S  TH AH AA K  S AH R AH 
सेट		S AH EH T AH 
सक्छ		S AH K  CHA AH 
लाग्यो		L AH AA G  Y AH OH 
देख्न		DH AH EH KA  N AH 
दाग		DH AH AA G AH 
त्यही		TH  Y AH HH AH IH 
समयमै		S AH M AH Y AH M AH AH IH 
लानुहोस्।		L AH AA N AH UH HH AH OH S  
रहित		R AH HH AH IH TH AH 
मुरि		M AH UH R AH IH 
बस्नुहोस्।		B AH S  N AH UH HH AH OH S  
दुखाई		DH AH UH KA AH AA IH 
दिएको		DH AH IH EH K AH OH 
थिएन।		THA AH IH EH N AH 
तपाईंहरु		TH AH P AH AA IH MHH AH R AH UH 
तपाईँले		TH AH P AH AA IHN L AH EH 
आउनु		AA UH N AH UH 
सोध्न		S AH OH DHA  N AH 
राखिदिनुहुन्छ		R AH AA KA AH IH DH AH IH N AH UH HH AH UH N  CHA AH 
मान्छेहरु		M AH AA N  CHA AH EH HH AH R AH UH 
भेट्ने		BA AH EH T  N AH EH 
बसको		B AH S AH K AH OH 
बर्षको		B AH R  S AH K AH OH 
बजार		B AH JH AH AA R AH 
डेजर्ट		D AH EH JH AH R  T AH 
खालि		KA AH AA L AH IH 
अर्थ		AH R  THA AH 
सूचना		S AH UH CH AH N AH AA 
श्याम्पू		S  Y AH AA M  P AH UH 
महिना		M AH HH AH IH N AH AA 
भेट्टाइन।		BA AH EH T  T AH AA IH N AH 
भनिन्छ		BA AH N AH IH N  CHA AH 
बेलामा		B AH EH L AH AA M AH AA 
बेर		B AH EH R AH 
बुझ्न		B AH UH JHA  N AH 
बाटोमा		B AH AA T AH OH M AH AA 
प्रत्येक		P  R AH TH  Y AH EH K AH 
पैदल		P AH AH IH DH AH L AH 
नगदमा		N AH G AH DH AH M AH AA 
ठ्याक्कै		TA  Y AH AA K  K AH AH IH 
टिकटहरू		T AH IH K AH T AH HH AH R AH UH 
जाओस्।		JH AH AA OH S  
कोर्ट		K AH OH R  T AH 
आरक्षण		AA R AH K  S AH N AH 
अडर		AH D AH R AH 
हुन्न		HH AH UH N  N AH 
स्वागत		S  W AH AA G AH TH AH 
सरसामान		S AH R AH S AH AA M AH AA N AH 
सडक		S AH D AH K AH 
ल्याउन		L  Y AH AA UH N AH 
रुमाल		R AH UH M AH AA L AH 
यसबाट		Y AH S AH B AH AA T AH 
भएकोले		BA AH EH K AH OH L AH EH 
पोस्ट		P AH OH S  T AH 
कागज		K AH AA G AH JH AH 
अमेरिकन		AH M AH EH R AH IH K AH N AH 
सार्न		S AH AA R  N AH 
बान्ता		B AH AA N  TH AH AA 
निशुल्क		N AH IH S AH UH L  K AH 
देखाउनु		DH AH EH KA AH AA UH N AH UH 
छुट्टाछुट्टै		CHA AH UH T  T AH AA CHA AH UH T  T AH AH IH 
चासो		CH AH AA S AH OH 
गरिसकें।		G AH R AH IH S AH K AH EH M
ओ		OH 
उच्च		UH CH  CH AH 
सुत्ने		S AH UH TH  N AH EH 
सक्दो		S AH K  DH AH OH 
शुभरात्री।		S AH UH BA AH R AH AA TH  R AH IH 
ल्याइदिनुहोस्।		L  Y AH AA IH DH AH IH N AH UH HH AH OH S  
मेशिन		M AH EH S AH IH N AH 
मिति		M AH IH TH AH IH 
भाषामा		BA AH AA S AH AA M AH AA 
पुरै		P AH UH R AH AH IH 
डर		D AH R AH 
टेलीफोन		T AH EH L AH IH PA AH OH N AH 
टि		T AH IH 
जति।		JH AH TH AH IH 
कहिलेसम्म		K AH HH AH IH L AH EH S AH M  M AH 
अनुमति		AH N AH UH M AH TH AH IH 
अगाडिको		AH G AH AA D AH IH K AH OH 
हप्ता।		HH AH P  TH AH AA 
स्वाद		S  W AH AA DH AH 
सुट		S AH UH T AH 
लाग्दैन		L AH AA G  DH AH AH IH N AH 
पाएको		P AH AA EH K AH OH 
दु		DH AH UH 
त्यहि		TH  Y AH HH AH IH 
कतिचोटी		K AH TH AH IH CH AH OH T AH IH 
सान		S AH AA N AH 
साथ		S AH AA THA AH 
राखिदिनुहोस्।		R AH AA KA AH IH DH AH IH N AH UH HH AH OH S  
राखिएको		R AH AA KA AH IH EH K AH OH 
मिल्छ।		M AH IH L  CHA AH 
महिनाको		M AH HH AH IH N AH AA K AH OH 
मध्यम		M AH DHA  Y AH M AH 
भैसक्यो।		BA AH AH IH S AH K  Y AH OH 
पर्खनुपर्छ		P AH R  KA AH N AH UH P AH R  CHA AH 
त्यहा		TH  Y AH HH AH AA 
गर्नुपर्ने		G AH R  N AH UH P AH R  N AH EH 
कान		K AH AA N AH 
आउनुहोला।		AA UH N AH UH HH AH OH L AH AA 
आँखा		AAN KA AH AA 
हेलो		HH AH EH L AH OH 
साट्ने		S AH AA T  N AH EH 
संकलन		S AH MK AH L AH N AH 
बसबाट		B AH S AH B AH AA T AH 
बजेर		B AH JH AH EH R AH 
फोनमा		PA AH OH N AH M AH AA 
नुन		N AH UH N AH 
त्यसपछि		TH  Y AH S AH P AH CHA AH IH 
तुरुन्त		TH AH UH R AH UH N  TH AH 
तीनवटा		TH AH IH N AH W AH T AH AA 
तिनीहरुलाई		TH AH IH N AH IH HH AH R AH UH L AH AA IH 
चेकआउट		CH AH EH K AH AA UH T AH 
गर्नेछु।		G AH R  N AH EH CHA AH UH 
अन्तर्राष्ट्रिय		AH N  TH AH R  R AH AA S  T  R AH IH Y AH 
हेर्नुहोस्।		HH AH EH R  N AH UH HH AH OH S  
सेन्टर		S AH EH N  T AH R AH 
सूची		S AH UH CH AH IH 
सुल्क		S AH UH L  K AH 
साइजमा		S AH AA IH JH AH M AH AA 
समाबेश		S AH M AH AA B AH EH S AH 
वलेट		W AH L AH EH T AH 
वर्षको		W AH R  S AH K AH OH 
लैजानुहोस्।		L AH AH IH JH AH AA N AH UH HH AH OH S  
लिएको		L AH IH EH K AH OH 
याद		Y AH AA DH AH 
यही		Y AH HH AH IH 
पच्चीस		P AH CH  CH AH IH S AH 
थप		THA AH P AH 
छल्लिएँ।		CHA AH L  L AH IH EHN 
चिकेन		CH AH IH K AH EH N AH 
कार्डबाट		K AH AA R  D AH B AH AA T AH 
कसो		K AH S AH OH 
ए।		EH 
एयर		EH Y AH R AH 
हतारमा		HH AH TH AH AA R AH M AH AA 
स्वचालित		S  W AH CH AH AA L AH IH TH AH 
सुन्न		S AH UH N  N AH 
सिधै		S AH IH DHA AH AH IH 
सर		S AH R AH 
यहि		Y AH HH AH IH 
मिलेको		M AH IH L AH EH K AH OH 
भर्ना		BA AH R  N AH AA 
भनिदिनुहोस्।		BA AH N AH IH DH AH IH N AH UH HH AH OH S  
बेसबल		B AH EH S AH B AH L AH 
बिभाग		B AH IH BA AH AA G AH 
बच्चाको		B AH CH  CH AH AA K AH OH 
छुट्टै		CHA AH UH T  T AH AH IH 
गजब		G AH JH AH B AH 
एसले		EH S AH L AH EH 
समाचार		S AH M AH AA CH AH AA R AH 
सकिन्छ।		S AH K AH IH N  CHA AH 
यि		Y AH IH 
मेलबाट		M AH EH L AH B AH AA T AH 
मार्ग		M AH AA R  G AH 
पिउनुहुन्छ		P AH IH UH N AH UH HH AH UH N  CHA AH 
परिकार		P AH R AH IH K AH AA R AH 
धुन		DHA AH UH N AH 
देखिने		DH AH EH KA AH IH N AH EH 
थाह		THA AH AA HH AH 
त्यहाँको		TH  Y AH HH AH AAN K AH OH 
तानाका		TH AH AA N AH AA K AH AA 
खुट्टा		KA AH UH T  T AH AA 
साधारण		S AH AA DHA AH AA R AH N AH 
साँचै		S AH AAN CH AH AH IH 
सम्भव		S AH M  BA AH W AH 
वाईन		W AH AA IH N AH 
रुघा		R AH UH GA AH AA 
मागेको		M AH AA G AH EH K AH OH 
बेलुका		B AH EH L AH UH K AH AA 
बिचार		B AH IH CH AH AA R AH 
बत्ति		B AH TH  TH AH IH 
प्याक		P  Y AH AA K AH 
पाइने		P AH AA IH N AH EH 
पठाउनुहोस्।		P AH TA AH AA UH N AH UH HH AH OH S  
दोष		DH AH OH S AH 
दुखिरहेको		DH AH UH KA AH IH R AH HH AH EH K AH OH 
तिमी		TH AH IH M AH IH 
तस्वीर		TH AH S  W AH IH R AH 
तपाईँलाई		TH AH P AH AA IHN L AH AA IH 
ट्रान्सफर		T  R AH AA N  S AH PA AH R AH 
ट्याक्सीमा		T  Y AH AA K  S AH IH M AH AA 
टुर		T AH UH R AH 
जाऔं।		JH AH AA AH UN M
खानामा		KA AH AA N AH AA M AH AA 
हुन्छु।		HH AH UH N  CHA AH UH 
लग्यो।		L AH G  Y AH OH 
बटुवा		B AH T AH UH W AH AA 
फाराम		PA AH AA R AH AA M AH 
ड्रिंक		D  R AH IH MK AH 
ठिक्कको।		TA AH IH K  K AH K AH OH 
चक्की		CH AH K  K AH IH 
ओटा		OH T AH AA 
सार्वजनिक		S AH AA R  W AH JH AH N AH IH K AH 
सक्दैन।		S AH K  DH AH AH IH N AH 
सक्छ।		S AH K  CHA AH 
श्रीमान		S  R AH IH M AH AA N AH 
राख्नुहोला।		R AH AA KA  N AH UH HH AH OH L AH AA 
भएकोमा		BA AH EH K AH OH M AH AA 
बाटोबाट		B AH AA T AH OH B AH AA T AH 
नजीकै		N AH JH AH IH K AH AH IH 
दुईटा		DH AH UH IH T AH AA 
डी		D AH IH 
जब		JH AH B AH 
छैनन्।		CHA AH AH IH N AH N  
घरको		GA AH R AH K AH OH 
खेल्ने		KA AH EH L  N AH EH 
आम्बुलेन्स		AA M  B AH UH L AH EH N  S AH 
स्मिथ		S  M AH IH THA AH 
विमानस्थलमा		W AH IH M AH AA N AH S  THA AH L AH M AH AA 
लाइनमा		L AH AA IH N AH M AH AA 
रुचाउनुहुन्छ		R AH UH CH AH AA UH N AH UH HH AH UH N  CHA AH 
भर्नुहोस्।		BA AH R  N AH UH HH AH OH S  
भर्खर		BA AH R  KA AH R AH 
बिस		B AH IH S AH 
बर्गर		B AH R  G AH R AH 
फ्लाईटको		PA  L AH AA IH T AH K AH OH 
छौं		CHA AH AH UH M
छुट्यो।		CHA AH UH T  Y AH OH 
चिकित्सक		CH AH IH K AH IH TH  S AH K AH 
आलु		AA L AH UH 
म्याम		M  Y AH AA M AH 
भाषाको		BA AH AA S AH AA K AH OH 
बनाएको		B AH N AH AA EH K AH OH 
दुख्यो।		DH AH UH KA  Y AH OH 
ट्याक्सीबाट		T  Y AH AA K  S AH IH B AH AA T AH 
जापानीज		JH AH AA P AH AA N AH IH JH AH 
सेवाको		S AH EH W AH AA K AH OH 
लौ		L AH AH UH 
महोदय।		M AH HH AH OH DH AH Y AH 
बिलमा		B AH IH L AH M AH AA 
नाक		N AH AA K AH 
धुने		DHA AH UH N AH EH 
दिनुहोस््।		DH AH IH N AH UH HH AH OH S  
तर्फी		TH AH R  PA AH IH 
जापानिज		JH AH AA P AH AA N AH IH JH AH 
जानुहोस्		JH AH AA N AH UH HH AH OH S  
जानलाई		JH AH AA N AH L AH AA IH 
छौ।		CHA AH AH UH 
गाडीमा		G AH AA D AH IH M AH AA 
खोजेको		KA AH OH JH AH EH K AH OH 
एकैछिन।		EH K AH AH IH CHA AH IH N AH 
उत्पादन		UH TH  P AH AA DH AH N AH 
अन्तराष्ट्रिय		AH N  TH AH R AH AA S  T  R AH IH Y AH 
सुन्दा		S AH UH N  DH AH AA 
शिकागो		S AH IH K AH AA G AH OH 
रङ		R AH NG AH 
बोक्न		B AH OH K  N AH 
बच्चा		B AH CH  CH AH AA 
पुरा		P AH UH R AH AA 
पुग्छ।		P AH UH G  CHA AH 
पाँचवटा		P AH AAN CH AH W AH T AH AA 
देशमा		DH AH EH S AH M AH AA 
त्यसै		TH  Y AH S AH AH IH 
छिर्न		CHA AH IH R  N AH 
छिट्टै		CHA AH IH T  T AH AH IH 
ख़ुशी		KA AH UH S AH IH 
कडा		K AH D AH AA 
आवाज		AA W AH AA JH AH 
अहिलेको		AH HH AH IH L AH EH K AH OH 
सापटी		S AH AA P AH T AH IH 
संयुक्त		S AH MY AH UH K  TH AH 
संग्राहलय		S AH MG  R AH AA HH AH L AH Y AH 
शहरमा		S AH HH AH R AH M AH AA 
रहोस।		R AH HH AH OH S AH 
मनपर्ने		M AH N AH P AH R  N AH EH 
भर्न		BA AH R  N AH 
बोल्नुहुन्छ		B AH OH L  N AH UH HH AH UH N  CHA AH 
बलेन।		B AH L AH EH N AH 
बताउनुहोस्।		B AH TH AH AA UH N AH UH HH AH OH S  
पुग्यो।		P AH UH G  Y AH OH 
पर्याप्त		P AH R  Y AH AA P  TH AH 
नियम		N AH IH Y AH M AH 
झिटी		JHA AH IH T AH IH 
छोडेर		CHA AH OH D AH EH R AH 
गरे		G AH R AH EH 
गराउनु		G AH R AH AA UH N AH UH 
कुनचाहिं		K AH UH N AH CH AH AA HH AH IH M
एउटै		EH UH T AH AH IH 
हेरफेर		HH AH EH R AH PA AH EH R AH 
स्थल		S  THA AH L AH 
सुप		S AH UH P AH 
शुक्रबार		S AH UH K  R AH B AH AA R AH 
विदेशी		W AH IH DH AH EH S AH IH 
लाग्ने		L AH AA G  N AH EH 
भरी		BA AH R AH IH 
भएका		BA AH EH K AH AA 
बुझेँ।		B AH UH JHA AH EHN 
बरफ		B AH R AH PA AH 
फलफूल		PA AH L AH PA AH UH L AH 
नगर्नुहोस्।		N AH G AH R  N AH UH HH AH OH S  
डिपार्टमेन्ट		D AH IH P AH AA R  T AH M AH EH N  T AH 
चाँडो		CH AH AAN D AH OH 
कुर्नुहोस्।		K AH UH R  N AH UH HH AH OH S  
होस्		HH AH OH S  
सुत्न		S AH UH TH  N AH 
साटिदिनुहोस्।		S AH AA T AH IH DH AH IH N AH UH HH AH OH S  
समात्नुहोस्।		S AH M AH AA TH  N AH UH HH AH OH S  
व्यापार		W  Y AH AA P AH AA R AH 
ल्याउनुहोस्।		L  Y AH AA UH N AH UH HH AH OH S  
लगाउनु		L AH G AH AA UH N AH UH 
मिल्दैन।		M AH IH L  DH AH AH IH N AH 
मिलाईदिनुहोस्।		M AH IH L AH AA IH DH AH IH N AH UH HH AH OH S  
मिलाई		M AH IH L AH AA IH 
भिसा		BA AH IH S AH AA 
भरिदिनुहोला।		BA AH R AH IH DH AH IH N AH UH HH AH OH L AH AA 
देखाउनुहुन्छ		DH AH EH KA AH AA UH N AH UH HH AH UH N  CHA AH 
देखाइदिनुहोस्।		DH AH EH KA AH AA IH DH AH IH N AH UH HH AH OH S  
जाँदैछु।		JH AH AAN DH AH AH IH CHA AH UH 
छुट्टा		CHA AH UH T  T AH AA 
चढ्नुपर्छ		CH AH DA  N AH UH P AH R  CHA AH 
खोकी		KA AH OH K AH IH 
क्षेत्र		K  S AH EH TH  R AH 
उनलाई		UH N AH L AH AA IH 
इन।		IH N AH 
आउनुभएको		AA UH N AH UH BA AH EH K AH OH 
अहिलेसम्म		AH HH AH IH L AH EH S AH M  M AH 
ह्याम		HH  Y AH AA M AH 
हट		HH AH T AH 
सोध्नसक्छु		S AH OH DHA  N AH S AH K  CHA AH UH 
ल		L AH 
मिल्न		M AH IH L  N AH 
बुझें।		B AH UH JHA AH EH M
बस्नुहुनेछ		B AH S  N AH UH HH AH UH N AH EH CHA AH 
पराउँछु।		P AH R AH AA UHN CHA AH UH 
दिन।		DH AH IH N AH 
दाँया		DH AH AAN Y AH AA 
थिएँ		THA AH IH EHN 
चालीस		CH AH AA L AH IH S AH 
हाउस		HH AH AA UH S AH 
साईजको		S AH AA IH JH AH K AH OH 
सडकको		S AH D AH K AH K AH OH 
ल्याईदिनुहुन्छ		L  Y AH AA IH DH AH IH N AH UH HH AH UH N  CHA AH 
येनलाई		Y AH EH N AH L AH AA IH 
भर्खरै		BA AH R  KA AH R AH AH IH 
बोलाइ		B AH OH L AH AA IH 
बोर्डिंग		B AH OH R  D AH IH MG AH 
बी		B AH IH 
बस्नेछु।		B AH S  N AH EH CHA AH UH 
बस्दै		B AH S  DH AH AH IH 
बटन		B AH T AH N AH 
फेर्ने		PA AH EH R  N AH EH 
फर्केर		PA AH R  K AH EH R AH 
ठाँउलाई		TA AH AAN UH L AH AA IH 
छिन		CHA AH IH N AH 
छन		CHA AH N AH 
खानु		KA AH AA N AH UH 
क्लास		K  L AH AA S AH 
कुखुराको		K AH UH KA AH UH R AH AA K AH OH 
कला		K AH L AH AA 
कम्पनी		K AH M  P AH N AH IH 
आजराति		AA JH AH R AH AA TH AH IH 
अहिलेनै		AH HH AH IH L AH EH N AH AH IH 
हावा		HH AH AA W AH AA 
सेन्ट।		S AH EH N  T AH 
विभिन्न		W AH IH BA AH IH N  N AH 
रोज्छु।		R AH OH JH  CHA AH UH 
रेलमा		R AH EH L AH M AH AA 
मिस्टर		M AH IH S  T AH R AH 
भन्नुभयो		BA AH N  N AH UH BA AH Y AH OH 
बुझिन।		B AH UH JHA AH IH N AH 
पूर्ण		P AH UH R  N AH 
पार्टी		P AH AA R  T AH IH 
ट्राफिक		T  R AH AA PA AH IH K AH 
चीजहरु		CH AH IH JH AH HH AH R AH UH 
चित्र		CH AH IH TH  R AH 
गाडीको		G AH AA D AH IH K AH OH 
गाईड		G AH AA IH D AH 
उनीलाई		UH N AH IH L AH AA IH 
उनको		UH N AH K AH OH 
उता		UH TH AH AA 
अँ		AHN 
शुन्य		S AH UH N  Y AH 
वाइनको		W AH AA IH N AH K AH OH 
लगिदिनुहोस्।		L AH G AH IH DH AH IH N AH UH HH AH OH S  
मोटर		M AH OH T AH R AH 
मुख		M AH UH KA AH 
मगाउन		M AH G AH AA UH N AH 
भेट		BA AH EH T AH 
बिक्रि		B AH IH K  R AH IH 
बाट।		B AH AA T AH 
बाँया		B AH AAN Y AH AA 
न्यु		N  Y AH UH 
नलाग्ने		N AH L AH AA G  N AH EH 
त्यसमा		TH  Y AH S AH M AH AA 
तारिख		TH AH AA R AH IH KA AH 
डन		D AH N AH 
चालक		CH AH AA L AH K AH 
चलेन।		CH AH L AH EH N AH 
गडबडी		G AH D AH B AH D AH IH 
खोज्न		KA AH OH JH  N AH 
खानेकुरा		KA AH AA N AH EH K AH UH R AH AA 
कोड		K AH OH D AH 
कमजोर		K AH M AH JH AH OH R AH 
उपचार		UH P AH CH AH AA R AH 
उडानमा		UH D AH AA N AH M AH AA 
अत्तर		AH TH  TH AH R AH 
हवाईजहाज		HH AH W AH AA IH JH AH HH AH AA JH AH 
साबुन		S AH AA B AH UH N AH 
सबैको		S AH B AH AH IH K AH OH 
लिएँ।		L AH IH EHN 
राखेर		R AH AA KA AH EH R AH 
राखिदिनुहोला।		R AH AA KA AH IH DH AH IH N AH UH HH AH OH L AH AA 
प्राय		P  R AH AA Y AH 
पौडी		P AH AH UH D AH IH 
चेक आउँट समय के हो		CH AH EH K AH K AH EH 
गुलियो		G AH UH L AH IH Y AH OH 
एकपटक		EH K AH P AH T AH K AH 
आझै		AA JHA AH AH IH 
आउँदैन।		AA UHN DH AH AH IH N AH 
अतिनै		AH TH AH IH N AH AH IH 
ह्विस्की		HH  W AH IH S  K AH IH 
हवाइ		HH AH W AH AA IH 
हवस्।		HH AH W AH S  
स्वीकार्नुहुन्छ		S  W AH IH K AH AA R  N AH UH HH AH UH N  CHA AH 
सक्दैनौं।		S AH K  DH AH AH IH N AH AH UH M
शौचालयको		S AH AH UH CH AH AA L AH Y AH K AH OH 
वेल		W AH EH L AH 
रेलगाडी		R AH EH L AH G AH AA D AH IH 
रुची		R AH UH CH AH IH 
मध्ये		M AH DHA  Y AH EH 
भएपनि		BA AH EH P AH N AH IH 
प्लेट		P  L AH EH T AH 
पुल		P AH UH L AH 
पार्सल		P AH AA R  S AH L AH 
पार्यो।		P AH AA R  Y AH OH 
पारिदिन		P AH AA R AH IH DH AH IH N AH 
डिस्को		D AH IH S  K AH OH 
ठाउँहरु		TA AH AA UHN HH AH R AH UH 
ट्याग		T  Y AH AA G AH 
जान्नसक्छु		JH AH AA N  N AH S AH K  CHA AH UH 
गोलिगाँठो		G AH OH L AH IH G AH AAN TA AH OH 
क्यामेराको		K  Y AH AA M AH EH R AH AA K AH OH 
कोठाहरु		K AH OH TA AH AA HH AH R AH UH 
आई		AA IH 
हवाईमेल		HH AH W AH AA IH M AH EH L AH 
हराइरहेको		HH AH R AH AA IH R AH HH AH EH K AH OH 
संगीत		S AH MG AH IH TH AH 
रकम		R AH K AH M AH 
मंगाउन		M AH MG AH AA UH N AH 
भ्रमणहरु		BA  R AH M AH N AH HH AH R AH UH 
बिमानस्थल		B AH IH M AH AA N AH S  THA AH L AH 
बज्यो।		B AH JH  Y AH OH 
पुर्		P AH UH R  
पाउने		P AH AA UH N AH EH 
देखाइदिनुहुन्थ्यो		DH AH EH KA AH AA IH DH AH IH N AH UH HH AH UH N  THA  Y AH OH 
दावी		DH AH AA W AH IH 
ठाउँको		TA AH AA UHN K AH OH 
टर्मिनल		T AH R  M AH IH N AH L AH 
ग्यास		G  Y AH AA S AH 
होटलमा।		HH AH OH T AH L AH M AH AA 
हुँदै		HH AH UHN DH AH AH IH 
स्कच		S  K AH CH AH 
सुनेको		S AH UH N AH EH K AH OH 
सहरमा		S AH HH AH R AH M AH AA 
सक्छौ		S AH K  CHA AH AH UH 
सकिने		S AH K AH IH N AH EH 
विमा		W AH IH M AH AA 
विभाग		W AH IH BA AH AA G AH 
रे		R AH EH 
मतलब		M AH TH AH L AH B AH 
भाउ		BA AH AA UH 
बीचमा		B AH IH CH AH M AH AA 
बिसौनी		B AH IH S AH AH UH N AH IH 
बिमान		B AH IH M AH AA N AH 
बाथटब		B AH AA THA AH T AH B AH 
बाकसमा		B AH AA K AH S AH M AH AA 
बदल्नु		B AH DH AH L  N AH UH 
पाएँ।		P AH AA EHN 
पाईने		P AH AA IH N AH EH 
ग्यारेन्टी		G  Y AH AA R AH EH N  T AH IH 
गाढा		G AH AA DA AH AA 
गर्छु		G AH R  CHA AH UH 
खाट		KA AH AA T AH 
कोर्स		K AH OH R  S AH 
कृपया।		K AH R P AH Y AH AA 
कतिजना		K AH TH AH IH JH AH N AH AA 
एकरातको		EH K AH R AH AA TH AH K AH OH 
अठार		AH TA AH AA R AH 
हुँदैन।		HH AH UHN DH AH AH IH N AH 
स्टेसनमा		S  T AH EH S AH N AH M AH AA 
सस्तोमा		S AH S  TH AH OH M AH AA 
विहानको		W AH IH HH AH AA N AH K AH OH 
वाटर		W AH AA T AH R AH 
लेन्स		L AH EH N  S AH 
राष्ट्रिय		R AH AA S  T  R AH IH Y AH 
यात्रामा		Y AH AA TH  R AH AA M AH AA 
यतिनै		Y AH TH AH IH N AH AH IH 
महिलाको		M AH HH AH IH L AH AA K AH OH 
ब्रान्ड		B  R AH AA N  D AH 
प्रश्न		P  R AH S  N AH 
पेटी		P AH EH T AH IH 
पुग्छ		P AH UH G  CHA AH 
पाउँ।		P AH AA UHN 
पाइन्छ।		P AH AA IH N  CHA AH 
नून		N AH UH N AH 
त्यती		TH  Y AH TH AH IH 
तिर्नु		TH AH IH R  N AH UH 
टुक्रा		T AH UH K  R AH AA 
जाँच्न		JH AH AAN CH  N AH 
चलेको		CH AH L AH EH K AH OH 
गर्छन्।		G AH R  CHA AH N  
एकै		EH K AH AH IH 
आएर		AA EH R AH 
आइतबार		AA IH TH AH B AH AA R AH 
अर्कै		AH R  K AH AH IH 
सापट		S AH AA P AH T AH 
सबभन्दा		S AH B AH BA AH N  DH AH AA 
सत्तरी		S AH TH  TH AH R AH IH 
सक्छौं।		S AH K  CHA AH AH UH M
ल्याउनु		L  Y AH AA UH N AH UH 
भैरहेको		BA AH AH IH R AH HH AH EH K AH OH 
भन्नु		BA AH N  N AH UH 
बनाईदिनुहोस्।		B AH N AH AA IH DH AH IH N AH UH HH AH OH S  
फर्कने		PA AH R  K AH N AH EH 
पोस्टकार्ड		P AH OH S  T AH K AH AA R  D AH 
पर्दैन		P AH R  DH AH AH IH N AH 
पठाईदिनुहोस्।		P AH TA AH AA IH DH AH IH N AH UH HH AH OH S  
निषेध		N AH IH S AH EH DHA AH 
निश्चित		N AH IH S  CH AH IH TH AH 
निको		N AH IH K AH OH 
त्यो कुन कपडा हो		TH  Y AH OH HH AH OH 
तिरबाट।		TH AH IH R AH B AH AA T AH 
तापक्रम		TH AH AA P AH K  R AH M AH 
ताजा		TH AH AA JH AH AA 
तपाईं।		TH AH P AH AA IH M
ट्रभेलर्स		T  R AH BA AH EH L AH R  S AH 
जोडी		JH AH OH D AH IH 
जाऊ।		JH AH AA UH 
गेम		G AH EH M AH 
गरुँ		G AH R AH UHN 
उहॉ		UH HH AH 
उहाँले		UH HH AH AAN L AH EH 
उपहारको		UH P AH HH AH AA R AH K AH OH 
सिक्का		S AH IH K  K AH AA 
संगैको		S AH MG AH AH IH K AH OH 
लेराईदिनुहोला।		L AH EH R AH AA IH DH AH IH N AH UH HH AH OH L AH AA 
लेख्नुहोस्।		L AH EH KA  N AH UH HH AH OH S  
लेखेको		L AH EH KA AH EH K AH OH 
लेखिएको		L AH EH KA AH IH EH K AH OH 
लगिदिन		L AH G AH IH DH AH IH N AH 
योर्कको		Y AH OH R  K AH K AH OH 
यु		Y AH UH 
मूल्यवान		M AH UH L  Y AH W AH AA N AH 
मीठो		M AH IH TA AH OH 
मद्धे		M AH DH  DHA AH EH 
भेटौँला।		BA AH EH T AH AH UHN L AH AA 
बोर्डिङ		B AH OH R  D AH IH NG AH 
पोशाकको		P AH OH S AH AA K AH K AH OH 
तिनीहरुले		TH AH IH N AH IH HH AH R AH UH L AH EH 
टेबलमा		T AH EH B AH L AH M AH AA 
जोर		JH AH OH R AH 
चम्चा		CH AH M  CH AH AA 
गर्मि		G AH R  M AH IH 
गर्छ।		G AH R  CHA AH 
कुनाबाट		K AH UH N AH AA B AH AA T AH 
कामना।		K AH AA M AH N AH AA 
कतिबेर		K AH TH AH IH B AH EH R AH 
आएको।		AA EH K AH OH 
सास		S AH AA S AH 
साना		S AH AA N AH AA 
साँझको		S AH AAN JHA AH K AH OH 
सकियो।		S AH K AH IH Y AH OH 
लाईनमा		L AH AA IH N AH M AH AA 
लाइट		L AH AA IH T AH 
रेस्टुरेन्टमा		R AH EH S  T AH UH R AH EH N  T AH M AH AA 
या		Y AH AA 
यदी		Y AH DH AH IH 
महङ्गो		M AH HH AH NG  G AH OH 
भनिदिनुहुन्थ्यो		BA AH N AH IH DH AH IH N AH UH HH AH UH N  THA  Y AH OH 
भइरहेको		BA AH IH R AH HH AH EH K AH OH 
बुझ्छु।		B AH UH JHA  CHA AH UH 
बिफ		B AH IH PA AH 
बाहेक		B AH AA HH AH EH K AH 
प्यासेज		P  Y AH AA S AH EH JH AH 
पर्म		P AH R  M AH 
पठाईदिनुहुन्छ		P AH TA AH AA IH DH AH IH N AH UH HH AH UH N  CHA AH 
निश्चयनै		N AH IH S  CH AH Y AH N AH AH IH 
निर्गमद्वार		N AH IH R  G AH M AH DH  W AH AA R AH 
दुख्छ		DH AH UH KA  CHA AH 
तस्बिर		TH AH S  B AH IH R AH 
डेजर्टको		D AH EH JH AH R  T AH K AH OH 
ठक्कर		TA AH K  K AH R AH 
चिप्स		CH AH IH P  S AH 
घण्टाको		GA AH N  T AH AA K AH OH 
गर्दैछ।		G AH R  DH AH AH IH CHA AH 
गयो।		G AH Y AH OH 
किनेको		K AH IH N AH EH K AH OH 
एस		EH S AH 
एम्बुलेन्स		EH M  B AH UH L AH EH N  S AH 
एकदिनको		EH K AH DH AH IH N AH K AH OH 
साट्नुहुन्छ		S AH AA T  N AH UH HH AH UH N  CHA AH 
समुद्री		S AH M AH UH DH  R AH IH 
विसौनीहरु		W AH IH S AH AH UH N AH IH HH AH R AH UH 
लिनेछु।		L AH IH N AH EH CHA AH UH 
लिनुपर्छ		L AH IH N AH UH P AH R  CHA AH 
रुघाको		R AH UH GA AH AA K AH OH 
मेरी		M AH EH R AH IH 
भर्ने		BA AH R  N AH EH 
बोल्नु		B AH OH L  N AH UH 
बेच्नुहुन्छ		B AH EH CH  N AH UH HH AH UH N  CHA AH 
बढि		B AH DA AH IH 
फ्लइट		PA  L AH IH T AH 
पेटको		P AH EH T AH K AH OH 
पाउनु		P AH AA UH N AH UH 
नम्बर।		N AH M  B AH R AH 
देख्नुभयो		DH AH EH KA  N AH UH BA AH Y AH OH 
तर्फ		TH AH R  PA AH 
जोन		JH AH OH N AH 
चक्कु		CH AH K  K AH UH 
खराब		KA AH R AH AA B AH 
कन्सर्ट		K AH N  S AH R  T AH 
उडानको		UH D AH AA N AH K AH OH 
हेरौं।		HH AH EH R AH AH UH M
हुनु		HH AH UH N AH UH 
सिकागो		S AH IH K AH AA G AH OH 
साच्चै		S AH AA CH  CH AH AH IH 
सराहना		S AH R AH AA HH AH N AH AA 
यामादा		Y AH AA M AH AA DH AH AA 
मेडियम		M AH EH D AH IH Y AH M AH 
फस्ट		PA AH S  T AH 
प्रस्तुति		P  R AH S  TH AH UH TH AH IH 
पिरो		P AH IH R AH OH 
पार्कमा		P AH AA R  K AH M AH AA 
पसलको		P AH S AH L AH K AH OH 
नगद।		N AH G AH DH AH 
देखिन्छ		DH AH EH KA AH IH N  CHA AH 
टी		T AH IH 
छूट		CHA AH UH T AH 
छुटाएँ।		CHA AH UH T AH AA EHN 
चोरीको		CH AH OH R AH IH K AH OH 
घण्टामा		GA AH N  T AH AA M AH AA 
गडबड		G AH D AH B AH D AH 
खाता		KA AH AA TH AH AA 
कोठाबाट		K AH OH TA AH AA B AH AA T AH 
कहिल्यै		K AH HH AH IH L  Y AH AH IH 
अंग्रेजीमा		AH MG  R AH EH JH AH IH M AH AA 
हिडेर		HH AH IH D AH EH R AH 
हल		HH AH L AH 
सेफ		S AH EH PA AH 
सूप		S AH UH P AH 
सिटको		S AH IH T AH K AH OH 
सातो		S AH AA TH AH OH 
सडकमा		S AH D AH K AH M AH AA 
श्रीमती		S  R AH IH M AH TH AH IH 
रेयर।		R AH EH Y AH R AH 
मेले		M AH EH L AH EH 
मुक्त		M AH UH K  TH AH 
मिलेन।		M AH IH L AH EH N AH 
मिटर		M AH IH T AH R AH 
मान्छेले		M AH AA N  CHA AH EH L AH EH 
भने।		BA AH N AH EH 
बोलाइदिन		B AH OH L AH AA IH DH AH IH N AH 
प्रमुख		P  R AH M AH UH KA AH 
पुग्नसक्छु		P AH UH G  N AH S AH K  CHA AH UH 
निश्चय		N AH IH S  CH AH Y AH 
थिच्नुहोस्।		THA AH IH CH  N AH UH HH AH OH S  
तिर्नुहुन्छ		TH AH IH R  N AH UH HH AH UH N  CHA AH 
तपाईं कुन समय ढोका खोल्नुहुन्छ		TH AH P AH AA IH MDA AH OH K AH AA 
जाऔं		JH AH AA AH UN M
छिटै		CHA AH IH T AH AH IH 
गोल्फ		G AH OH L  PA AH 
खातामा		KA AH AA TH AH AA M AH AA 
कुराहरु		K AH UH R AH AA HH AH R AH UH 
कम्पनीको		K AH M  P AH N AH IH K AH OH 
कपालको		K AH P AH AA L AH K AH OH 
इस्त्री		IH S  TH  R AH IH 
आगलागी		AA G AH L AH AA G AH IH 
अपरेटर		AH P AH R AH EH T AH R AH 
होईन		HH AH OH IH N AH 
साँढे		S AH AAN DA AH EH 
सक्नुहुन्न।		S AH K  N AH UH HH AH UH N  N AH 
शो		S AH OH 
म्याम।		M  Y AH AA M AH 
मिस		M AH IH S AH 
भोजन		BA AH OH JH AH N AH 
भन्नुसहोस्।		BA AH N  N AH UH S AH HH AH OH S  
बजेट		B AH JH AH EH T AH 
पूरा		P AH UH R AH AA 
पुग्नकोलागि		P AH UH G  N AH K AH OH L AH AA G AH IH 
पुगेन।		P AH UH G AH EH N AH 
पत्ता		P AH TH  TH AH AA 
देश		DH AH EH S AH 
देब्रे		DH AH EH B  R AH EH 
दुध		DH AH UH DHA AH 
त्यस		TH  Y AH S AH 
तपाईंलाइ		TH AH P AH AA IH ML AH AA IH 
जूस		JH AH UH S AH 
जुलाई		JH AH UH L AH AA IH 
जानुभएको		JH AH AA N AH UH BA AH EH K AH OH 
चारवटा		CH AH AA R AH W AH T AH AA 
गरौँ		G AH R AH AH UHN 
गरिन्छ।		G AH R AH IH N  CHA AH 
किन्छु।		K AH IH N  CHA AH UH 
ओर्लिन्छु।		OH R  L AH IH N  CHA AH UH 
एउटाकोठा		EH UH T AH AA K AH OH TA AH AA 
अस्सी		AH S  S AH IH 
अरू		AH R AH UH 
हुनुभयो		HH AH UH N AH UH BA AH Y AH OH 
स्यान्डविच		S  Y AH AA N  D AH W AH IH CH AH 
श्रेणीको		S  R AH EH N AH IH K AH OH 
वास्तवमा		W AH AA S  TH AH W AH M AH AA 
लाईन		L AH AA IH N AH 
लगाउनुपर्छ		L AH G AH AA UH N AH UH P AH R  CHA AH 
रोकिन्छ		R AH OH K AH IH N  CHA AH 
रेष्टुरेन्ट		R AH EH S  T AH UH R AH EH N  T AH 
राम्रै		R AH AA M  R AH AH IH 
रात्री		R AH AA TH  R AH IH 
मेरोकोठा		M AH EH R AH OH K AH OH TA AH AA 
भैरहेछ।		BA AH AH IH R AH HH AH EH CHA AH 
भर		BA AH R AH 
बोल्दैहुनुहुन्छ		B AH OH L  DH AH AH IH HH AH UH N AH UH HH AH UH N  CHA AH 
प्रमाण		P  R AH M AH AA N AH 
नजीक		N AH JH AH IH K AH 
तपाईसंग		TH AH P AH AA IH S AH MG AH 
तपाँइको		TH AH P AH AAN IH K AH OH 
डाक्टरलाई		D AH AA K  T AH R AH L AH AA IH 
जानुहोला		JH AH AA N AH UH HH AH OH L AH AA 
जाँछ		JH AH AAN CHA AH 
चेकहरु		CH AH EH K AH HH AH R AH UH 
चाहेको		CH AH AA HH AH EH K AH OH 
चल्ने		CH AH L  N AH EH 
चलिरहेको		CH AH L AH IH R AH HH AH EH K AH OH 
गर्दैहुनुहुन्छ		G AH R  DH AH AH IH HH AH UH N AH UH HH AH UH N  CHA AH 
गरौं।		G AH R AH AH UH M
गरिरहेको		G AH R AH IH R AH HH AH EH K AH OH 
खिचिदिनुहुन्छ		KA AH IH CH AH IH DH AH IH N AH UH HH AH UH N  CHA AH 
खानको		KA AH AA N AH K AH OH 
खसालें।		KA AH S AH AA L AH EH M
ख		KA AH 
कोसेली		K AH OH S AH EH L AH IH 
काममा।		K AH AA M AH M AH AA 
कल।		K AH L AH 
कलम		K AH L AH M AH 
उस्तै		UH S  TH AH AH IH 
साटिदिन		S AH AA T AH IH DH AH IH N AH 
समान		S AH M AH AA N AH 
सटही		S AH T AH HH AH IH 
सक्छौँ		S AH K  CHA AH AH UHN 
शब्द		S AH B  DH AH 
लिस्ट		L AH IH S  T AH 
लागेन।		L AH AA G AH EH N AH 
राम्रा		R AH AA M  R AH AA 
राजदूतावासमा		R AH AA JH AH DH AH UH TH AH AA W AH AA S AH M AH AA 
रक्तचाप		R AH K  TH AH CH AH AA P AH 
महिला		M AH HH AH IH L AH AA 
बिहानी		B AH IH HH AH AA N AH IH 
प्रथम		P  R AH THA AH M AH 
पारिदिनुहोला।		P AH AA R AH IH DH AH IH N AH UH HH AH OH L AH AA 
पाँचको		P AH AAN CH AH K AH OH 
पसलहरु		P AH S AH L AH HH AH R AH UH 
तिमीले		TH AH IH M AH IH L AH EH 
ड्राई		D  R AH AA IH 
डि		D AH IH 
ट्रेनको		T  R AH EH N AH K AH OH 
जुत्ताको		JH AH UH TH  TH AH AA K AH OH 
चिट्ठी		CH AH IH T  TA AH IH 
चाहीं		CH AH AA HH AH IH M
गाडीले		G AH AA D AH IH L AH EH 
क्षेत्रमा		K  S AH EH TH  R AH M AH AA 
क्षेत्रको		K  S AH EH TH  R AH K AH OH 
कोशिस		K AH OH S AH IH S AH 
कही		K AH HH AH IH 
आरक्षित		AA R AH K  S AH IH TH AH 
हिलटन		HH AH IH L AH T AH N AH 
स्टपमा		S  T AH P AH M AH AA 
सादा		S AH AA DH AH AA 
सर्।		S AH R  
सर्ट		S AH R  T AH 
विहान		W AH IH HH AH AA N AH 
लेख्ने		L AH EH KA  N AH EH 
लेखिदिनुहोला।		L AH EH KA AH IH DH AH IH N AH UH HH AH OH L AH AA 
लिईदिन		L AH IH IH DH AH IH N AH 
लान		L AH AA N AH 
रोक्न		R AH OH K  N AH 
राख्नु		R AH AA KA  N AH UH 
राख्छु।		R AH AA KA  CHA AH UH 
याइदिनुहोस्।		Y AH AA IH DH AH IH N AH UH HH AH OH S  
बेलुकीको		B AH EH L AH UH K AH IH K AH OH 
बाजी		B AH AA JH AH IH 
बधाई		B AH DHA AH AA IH 
फ्राई		PA  R AH AA IH 
फ्रन्ट		PA  R AH N  T AH 
पठाइदिन		P AH TA AH AA IH DH AH IH N AH 
निम्तो		N AH IH M  TH AH OH 
दोश्रो		DH AH OH S  R AH OH 
ठाऊ		TA AH AA UH 
चालिस		CH AH AA L AH IH S AH 
खोल्नुहुन्छ		KA AH OH L  N AH UH HH AH UH N  CHA AH 
खानुहोस्।		KA AH AA N AH UH HH AH OH S  
केबल		K AH EH B AH L AH 
कसको		K AH S AH K AH OH 
हूँ।		HH AH UHN 
स्कच्		S  K AH CH  
सुनेर		S AH UH N AH EH R AH 
सुजुकी		S AH UH JH AH UH K AH IH 
सजिलै		S AH JH AH IH L AH AH IH 
लस्		L AH S  
रे।		R AH EH 
रेष्टुराँ		R AH EH S  T AH UH R AH AAN 
रक		R AH K AH 
माथिल्लो		M AH AA THA AH IH L  L AH OH 
भुमिगत		BA AH UH M AH IH G AH TH AH 
भिडियो		BA AH IH D AH IH Y AH OH 
भवनको		BA AH W AH N AH K AH OH 
भरिया		BA AH R AH IH Y AH AA 
बेस		B AH EH S AH 
बेरिदिनुहुन्छ		B AH EH R AH IH DH AH IH N AH UH HH AH UH N  CHA AH 
पुगिन्छ		P AH UH G AH IH N  CHA AH 
पार्न		P AH AA R  N AH 
पढ्न		P AH DA  N AH 
पठाउने		P AH TA AH AA UH N AH EH 
पठाईदिन्छु।		P AH TA AH AA IH DH AH IH N  CHA AH UH 
देशको		DH AH EH S AH K AH OH 
तलामा		TH AH L AH AA M AH AA 
जुस।		JH AH UH S AH 
जानसक्छु		JH AH AA N AH S AH K  CHA AH UH 
जाऔँ।		JH AH AA AH UNN 
छौँ।		CHA AH AH UHN 
छोडेको		CHA AH OH D AH EH K AH OH 
चेकले		CH AH EH K AH L AH EH 
ग्याँस		G  Y AH AAN S AH 
खारिज		KA AH AA R AH IH JH AH 
कुराको		K AH UH R AH AA K AH OH 
काउन्टरमा		K AH AA UH N  T AH R AH M AH AA 
कम्मल		K AH M  M AH L AH 
अफ		AH PA AH 
हेर्दै		HH AH EH R  DH AH AH IH 
हामीसित		HH AH AA M AH IH S AH IH TH AH 
सस		S AH S AH 
सक्नुहुन्न		S AH K  N AH UH HH AH UH N  N AH 
शुरुङ्गमार्गको		S AH UH R AH UH NG  G AH M AH AA R  G AH K AH OH 
व्यक्तिको		W  Y AH K  TH AH IH K AH OH 
राज्य		R AH AA JH  Y AH 
भएन		BA AH EH N AH 
बूक		B AH UH K AH 
बिशेषता		B AH IH S AH EH S AH TH AH AA 
बापत		B AH AA P AH TH AH 
बनाईदिन		B AH N AH AA IH DH AH IH N AH 
फ्रइट		PA  R AH IH T AH 
फर्कनुहोस्।		PA AH R  K AH N AH UH HH AH OH S  
पुस्तक		P AH UH S  TH AH K AH 
पर्खिनुहोस्।		P AH R  KA AH IH N AH UH HH AH OH S  
नपर्ने		N AH P AH R  N AH EH 
देखेर		DH AH EH KA AH EH R AH 
देखिनु		DH AH EH KA AH IH N AH UH 
दियो।		DH AH IH Y AH OH 
तारिकको		TH AH AA R AH IH K AH K AH OH 
डिपोजिट		D AH IH P AH OH JH AH IH T AH 
टेलिग्राम		T AH EH L AH IH G  R AH AA M AH 
चुप		CH AH UH P AH 
चाहिएको		CH AH AA HH AH IH EH K AH OH 
गेटमा		G AH EH T AH M AH AA 
गम्भीर		G AH M  BA AH IH R AH 
खुल्ने		KA AH UH L  N AH EH 
खास		KA AH AA S AH 
खानुहोला।		KA AH AA N AH UH HH AH OH L AH AA 
खाए		KA AH AA EH 
क्यामरा		K  Y AH AA M AH R AH AA 
केटा		K AH EH T AH AA 
कारण		K AH AA R AH N AH 
काट्नुहोस्।		K AH AA T  N AH UH HH AH OH S  
एल		EH L AH 
सुन		S AH UH N AH 
सट्टा		S AH T  T AH AA 
वस्तु		W AH S  TH AH UH 
लैजानको		L AH AH IH JH AH AA N AH K AH OH 
लिमोजिन		L AH IH M AH OH JH AH IH N AH 
लण्डन		L AH N  D AH N AH 
मिलाईदिनुहोला।		M AH IH L AH AA IH DH AH IH N AH UH HH AH OH L AH AA 
फर्किने		PA AH R  K AH IH N AH EH 
पार		P AH AA R AH 
पर्यो		P AH R  Y AH OH 
नियमित		N AH IH Y AH M AH IH TH AH 
दोहोर्याउन		DH AH OH HH AH OH R  Y AH AA UH N AH 
तपाइलाई		TH AH P AH AA IH L AH AA IH 
ड्रेस		D  R AH EH S AH 
ठट्टा		TA AH T  T AH AA 
ट्यक्सी		T  Y AH K  S AH IH 
टिभीमा		T AH IH BA AH IH M AH AA 
जापानि		JH AH AA P AH AA N AH IH 
घुम्ने		GA AH UH M  N AH EH 
गरिदिनुहोस।		G AH R AH IH DH AH IH N AH UH HH AH OH S AH 
कोसिस		K AH OH S AH IH S AH 
किनभने		K AH IH N AH BA AH N AH EH 
काँचो		K AH AAN CH AH OH 
कतिको		K AH TH AH IH K AH OH 
एसी		EH S AH IH 
आफ्नै		AA PA  N AH AH IH 
आगमन		AA G AH M AH N AH 
अनौठो		AH N AH AH UH TA AH OH 
हरु		HH AH R AH UH 
हतार		HH AH TH AH AA R AH 
स्वतन्त्र		S  W AH TH AH N  TH  R AH 
स्ट्रीट		S  T  R AH IH T AH 
स्टेशनबाट		S  T AH EH S AH N AH B AH AA T AH 
सिक्काहरु		S AH IH K  K AH AA HH AH R AH UH 
सामग्री		S AH AA M AH G  R AH IH 
साटिदिनु		S AH AA T AH IH DH AH IH N AH UH 
सजावट		S AH JH AH AA W AH T AH 
सक्कली		S AH K  K AH L AH IH 
शनिबार		S AH N AH IH B AH AA R AH 
लाग्ला		L AH AA G  L AH AA 
रेगुलर		R AH EH G AH UH L AH R AH 
मिनेट।		M AH IH N AH EH T AH 
मध्य		M AH DHA  Y AH 
बेल्ट		B AH EH L  T AH 
बेकन		B AH EH K AH N AH 
बस्टन		B AH S  T AH N AH 
बसेर		B AH S AH EH R AH 
बरु		B AH R AH UH 
बनाइदिनुहोला।		B AH N AH AA IH DH AH IH N AH UH HH AH OH L AH AA 
बदल्नुपर्छ		B AH DH AH L  N AH UH P AH R  CHA AH 
प्रयास		P  R AH Y AH AA S AH 
पोलेको		P AH OH L AH EH K AH OH 
पेन		P AH EH N AH 
पाउण्ड		P AH AA UH N  D AH 
पढ्दैछु।		P AH DA  DH AH AH IH CHA AH UH 
पख्नुहोस्।		P AH KA  N AH UH HH AH OH S  
नामको		N AH AA M AH K AH OH 
नाटक		N AH AA T AH K AH 
धेत्तेरिका।		DHA AH EH TH  TH AH EH R AH IH K AH AA 
दुईजनाको		DH AH UH IH JH AH N AH AA K AH OH 
दयालु		DH AH Y AH AA L AH UH 
ढल्काउन		DA AH L  K AH AA UH N AH 
ठाँउ		TA AH AAN UH 
टूरको		T AH UH R AH K AH OH 
झ्यालमा		JHA  Y AH AA L AH M AH AA 
छन।		CHA AH N AH 
चिल्लो		CH AH IH L  L AH OH 
चाहिं।		CH AH AA HH AH IH M
कुपन		K AH UH P AH N AH 
कार्यक्रमको		K AH AA R  Y AH K  R AH M AH K AH OH 
कार्डको		K AH AA R  D AH K AH OH 
कम्मर		K AH M  M AH R AH 
आकारको		AA K AH AA R AH K AH OH 
आएन।		AA EH N AH 
आइ		AA IH 
हेयर		HH AH EH Y AH R AH 
स्विटर		S  W AH IH T AH R AH 
सोमबार		S AH OH M AH B AH AA R AH 
सेवा।		S AH EH W AH AA 
साइड		S AH AA IH D AH 
सांगीतिक		S AH AA MG AH IH TH AH IH K AH 
सट्टामा		S AH T  T AH AA M AH AA 
वियर		W AH IH Y AH R AH 
लेख्न		L AH EH KA  N AH 
राखि		R AH AA KA AH IH 
योग्य		Y AH OH G  Y AH 
येनको		Y AH EH N AH K AH OH 
मेरोलागि		M AH EH R AH OH L AH AA G AH IH 
मान्य		M AH AA N  Y AH 
भन्नुभएको		BA AH N  N AH UH BA AH EH K AH OH 
ब्यक्ती		B  Y AH K  TH AH IH 
बाँयातिर		B AH AAN Y AH AA TH AH IH R AH 
पोशाक		P AH OH S AH AA K AH 
पिउनको		P AH IH UH N AH K AH OH 
पठाईदिनुहोला।		P AH TA AH AA IH DH AH IH N AH UH HH AH OH L AH AA 
न्यूयोर्क		N  Y AH UH Y AH OH R  K AH 
नी		N AH IH 
नया		N AH Y AH AA 
तारिखमा		TH AH AA R AH IH KA AH M AH AA 
ठिक्क		TA AH IH K  K AH 
ट्रावल		T  R AH AA W AH L AH 
टोस्ट		T AH OH S  T AH 
जती		JH AH TH AH IH 
छेउमा		CHA AH EH UH M AH AA 
छाडिदिनुहोला।		CHA AH AA D AH IH DH AH IH N AH UH HH AH OH L AH AA 
चेकईन		CH AH EH K AH IH N AH 
गर्छौं।		G AH R  CHA AH AH UH M
गरेन।		G AH R AH EH N AH 
केचप		K AH EH CH AH P AH 
कत्तिको		K AH TH  TH AH IH K AH OH 
कतिवर्षको		K AH TH AH IH W AH R  S AH K AH OH 
औंठी		AH UN MTA AH IH 
ओर्लिने		OH R  L AH IH N AH EH 
ओर्लन		OH R  L AH N AH 
एकलाई		EH K AH L AH AA IH 
उचित		UH CH AH IH TH AH 
आईपुग्छ		AA IH P AH UH G  CHA AH 
समस्यामा		S AH M AH S  Y AH AA M AH AA 
सधैं		S AH DHA AH AH IH M
विश्वास		W AH IH S  W AH AA S AH 
लाग्नु		L AH AA G  N AH UH 
रेड		R AH EH D AH 
यतातिर		Y AH TH AH AA TH AH IH R AH 
भुलेछु।		BA AH UH L AH EH CHA AH UH 
भनी		BA AH N AH IH 
बस्तु		B AH S  TH AH UH 
बनाउनुहोस्।		B AH N AH AA UH N AH UH HH AH OH S  
बनाईदिनुहुन्छ		B AH N AH AA IH DH AH IH N AH UH HH AH UH N  CHA AH 
प्वाल		P  W AH AA L AH 
प्रिसक्रिपसन		P  R AH IH S AH K  R AH IH P AH S AH N AH 
प्रसिद्ध		P  R AH S AH IH DH  DHA AH 
पुनपक्का		P AH UH N AH P AH K  K AH AA 
पातलो		P AH AA TH AH L AH OH 
दिएकोमा		DH AH IH EH K AH OH M AH AA 
तौल		TH AH AH UH L AH 
तिस		TH AH IH S AH 
तारिखको		TH AH AA R AH IH KA AH K AH OH 
डेस्कमा		D AH EH S  K AH M AH AA 
टिप्न		T AH IH P  N AH 
जुत्ताहरु		JH AH UH TH  TH AH AA HH AH R AH UH 
जहाँ		JH AH HH AH AAN 
चेकलाई		CH AH EH K AH L AH AA IH 
घाउ		GA AH AA UH 
ग्रिन		G  R AH IH N AH 
गर्नुभयो।		G AH R  N AH UH BA AH Y AH OH 
खुला		KA AH UH L AH AA 
खान्छु।		KA AH AA N  CHA AH UH 
केक		K AH EH K AH 
कृपाया		K AH R P AH AA Y AH AA 
किसिमका		K AH IH S AH IH M AH K AH AA 
कमिज		K AH M AH IH JH AH 
औपचारिक		AH UN P AH CH AH AA R AH IH K AH 
उत्तर		UH TH  TH AH R AH 
आकस्मिक		AA K AH S  M AH IH K AH 
आइपुगेको		AA IH P AH UH G AH EH K AH OH 
होसियार		HH AH OH S AH IH Y AH AA R AH 
हेरिरहेको		HH AH EH R AH IH R AH HH AH EH K AH OH 
हाम		HH AH AA M AH 
हन्छ।		HH AH N  CHA AH 
स्क्वायर		S  K  W AH AA Y AH R AH 
सोडा		S AH OH D AH AA 
सेन्टको		S AH EH N  T AH K AH OH 
सरुवा		S AH R AH UH W AH AA 
समेत		S AH M AH EH TH AH 
लोकल		L AH OH K AH L AH 
लगाउनुहोस्।		L AH G AH AA UH N AH UH HH AH OH S  
रुट		R AH UH T AH 
मोड्नुहोला।		M AH OH D  N AH UH HH AH OH L AH AA 
मिलाईदिनुहुन्छ		M AH IH L AH AA IH DH AH IH N AH UH HH AH UH N  CHA AH 
महङंगो		M AH HH AH NG AH MG AH OH 
भ्रमणहरू		BA  R AH M AH N AH HH AH R AH UH 
भइरहेछ।		BA AH IH R AH HH AH EH CHA AH 
बोल्दै		B AH OH L  DH AH AH IH 
बक्स		B AH K  S AH 
पेटमा		P AH EH T AH M AH AA 
पुलिस		P AH UH L AH IH S AH 
पुग्छौं		P AH UH G  CHA AH AH UH M
पानीको		P AH AA N AH IH K AH OH 
पछिको		P AH CHA AH IH K AH OH 
पछाडिको		P AH CHA AH AA D AH IH K AH OH 
नी।		N AH IH 
निक्कै		N AH IH K  K AH AH IH 
नाकबाट		N AH AA K AH B AH AA T AH 
दाँयातिर		DH AH AAN Y AH AA TH AH IH R AH 
दस्तखत		DH AH S  TH AH KA AH TH AH 
तपाईंको भ्रमणको उदेश्य के हो 		TH AH P AH AA IH MK AH OH K AH EH 
तकिया		TH AH K AH IH Y AH AA 
टूरहरु		T AH UH R AH HH AH R AH UH 
छौँ		CHA AH AH UHN 
चेकमा		CH AH EH K AH M AH AA 
चलाउने		CH AH L AH AA UH N AH EH 
गरेका		G AH R AH EH K AH AA 
गरिदिनुहोस्		G AH R AH IH DH AH IH N AH UH HH AH OH S  
खेलौना		KA AH EH L AH AH UH N AH AA 
एम		EH M AH 
एन		EH N AH 
आउनुहोस्		AA UH N AH UH HH AH OH S  
सुश्री		S AH UH S  R AH IH 
सिट।		S AH IH T AH 
सिटी		S AH IH T AH IH 
सहन		S AH HH AH N AH 
सर्भीस		S AH R  BA AH IH S AH 
सन		S AH N AH 
संगित		S AH MG AH IH TH AH 
शावर		S AH AA W AH R AH 
व्हिस्की		W  HH AH IH S  K AH IH 
विभागमा		W AH IH BA AH AA G AH M AH AA 
वस्तुहरु		W AH S  TH AH UH HH AH R AH UH 
लगाएको		L AH G AH AA EH K AH OH 
रात्रि		R AH AA TH  R AH IH 
यात्रु		Y AH AA TH  R AH UH 
यसबारे		Y AH S AH B AH AA R AH EH 
मुटु		M AH UH T AH UH 
भेटौंल		BA AH EH T AH AH UH ML AH 
भरिदीनुहोस्।		BA AH R AH IH DH AH IH N AH UH HH AH OH S  
भनेर।		BA AH N AH EH R AH 
बेड		B AH EH D AH 
बिच		B AH IH CH AH 
बाहुला		B AH AA HH AH UH L AH AA 
बल		B AH L AH 
फोहोर		PA AH OH HH AH OH R AH 
फेर्नुहोस्।		PA AH EH R  N AH UH HH AH OH S  
प्रतिक्षा		P  R AH TH AH IH K  S AH AA 
प्याज		P  Y AH AA JH AH 
पुरुषको		P AH UH R AH UH S AH K AH OH 
पर		P AH R AH 
न्यानो		N  Y AH AA N AH OH 
दिउसोको		DH AH IH UH S AH OH K AH OH 
दाह्री		DH AH AA HH  R AH IH 
ढाड		DA AH AA D AH 
टोकियोबाट		T AH OH K AH IH Y AH OH B AH AA T AH 
छोरा		CHA AH OH R AH AA 
चाहिने		CH AH AA HH AH IH N AH EH 
घाइते		GA AH AA IH TH AH EH 
घन्टाको		GA AH N  T AH AA K AH OH 
गाइड्		G AH AA IH D  
खाएको		KA AH AA EH K AH OH 
के भयो		K AH EH 
काममा		K AH AA M AH M AH AA 
कागती		K AH AA G AH TH AH IH 
कसरी  जान सक्छु		K AH S AH R AH IH S AH K  CHA AH UH 
औजार		AH UN JH AH AA R AH 
एकको		EH K AH K AH OH 
इन्		IH N  
आसपासमा		AA S AH P AH AA S AH M AH AA 
आएँ।		AA EHN 
आउनुभयो		AA UH N AH UH BA AH Y AH OH 
आउँदै		AA UHN DH AH AH IH 
हुनसक्छ।		HH AH UH N AH S AH K  CHA AH 
हुँ		HH AH UHN 
हामीकहाँ		HH AH AA M AH IH K AH HH AH AAN 
हफ्ता		HH AH PA  TH AH AA 
स्वादिलो		S  W AH AA DH AH IH L AH OH 
सिरानी		S AH IH R AH AA N AH IH 
सिद्धियो।		S AH IH DH  DHA AH IH Y AH OH 
सब		S AH B AH 
सत्र		S AH TH  R AH 
विमान		W AH IH M AH AA N AH 
रिजर्ब		R AH IH JH AH R  B AH 
राख्दिनुहुन्छ		R AH AA KA  DH AH IH N AH UH HH AH UH N  CHA AH 
रहन्छ		R AH HH AH N  CHA AH 
यहाँलाई		Y AH HH AH AAN L AH AA IH 
मिनिरल		M AH IH N AH IH R AH L AH 
माइलेज		M AH AA IH L AH EH JH AH 
भिजा		BA AH IH JH AH AA 
भागमा		BA AH AA G AH M AH AA 
भरिदिनुहुन्छ		BA AH R AH IH DH AH IH N AH UH HH AH UH N  CHA AH 
ब्रेक		B  R AH EH K AH 
बुधबार		B AH UH DHA AH B AH AA R AH 
बारमा		B AH AA R AH M AH AA 
बलियो		B AH L AH IH Y AH OH 
बनाउने		B AH N AH AA UH N AH EH 
फेर्नुपर्छ		PA AH EH R  N AH UH P AH R  CHA AH 
फिलिम		PA AH IH L AH IH M AH 
पूरै		P AH UH R AH AH IH 
पर्खनुहुन्छ		P AH R  KA AH N AH UH HH AH UH N  CHA AH 
नुहाउन		N AH UH HH AH AA UH N AH 
नरम		N AH R AH M AH 
देख्नुहुनेछ।		DH AH EH KA  N AH UH HH AH UH N AH EH CHA AH 
दुरीको		DH AH UH R AH IH K AH OH 
थिच्नुहोला।		THA AH IH CH  N AH UH HH AH OH L AH AA 
त्यो कति बेला		TH  Y AH OH 
त्याती		TH  Y AH AA TH AH IH 
डग		D AH G AH 
ज्वोरो		JH  W AH OH R AH OH 
जाँच्नुहोस्।		JH AH AAN CH  N AH UH HH AH OH S  
छीन		CHA AH IH N AH 
छलफल		CHA AH L AH PA AH L AH 
चढेर		CH AH DA AH EH R AH 
गोटा		G AH OH T AH AA 
खोलिदिनुहुन्छ		KA AH OH L AH IH DH AH IH N AH UH HH AH UH N  CHA AH 
क्यामर		K  Y AH AA M AH R AH 
कोठामै		K AH OH TA AH AA M AH AH IH 
कुर्नुपर्छ		K AH UH R  N AH UH P AH R  CHA AH 
कमिसन		K AH M AH IH S AH N AH 
ईन		IH N AH 
आवश्यकता		AA W AH S  Y AH K AH TH AH AA 
हुनुहुन्थ्यो		HH AH UH N AH UH HH AH UH N  THA  Y AH OH 
सामान्य		S AH AA M AH AA N  Y AH 
सक्नुहुँन्छ		S AH K  N AH UH HH AH UHN N  CHA AH 
लेखिदिन		L AH EH KA AH IH DH AH IH N AH 
लग्न		L AH G  N AH 
मिलाउनु		M AH IH L AH AA UH N AH UH 
मंगाएको		M AH MG AH AA EH K AH OH 
भ्रमणलाई		BA  R AH M AH N AH L AH AA IH 
भरेर		BA AH R AH EH R AH 
भएछ।		BA AH EH CHA AH 
बीसको		B AH IH S AH K AH OH 
बिग्रिने		B AH IH G  R AH IH N AH EH 
बस्नुपर्छ		B AH S  N AH UH P AH R  CHA AH 
बन्छ		B AH N  CHA AH 
बजेतिर		B AH JH AH EH TH AH IH R AH 
फोनको		PA AH OH N AH K AH OH 
प्रयोगको		P  R AH Y AH OH G AH K AH OH 
पेपर		P AH EH P AH R AH 
पेट्रोलबाट		P AH EH T  R AH OH L AH B AH AA T AH 
पुरुष		P AH UH R AH UH S AH 
पार्टीमा		P AH AA R  T AH IH M AH AA 
पाउँछु		P AH AA UHN CHA AH UH 
पाँचौं		P AH AAN CH AH AH UH M
परिक्षण		P AH R AH IH K  S AH N AH 
द्रुत		DH  R AH UH TH AH 
देखेको		DH AH EH KA AH EH K AH OH 
दुर्घटनाको		DH AH UH R  GA AH T AH N AH AA K AH OH 
दया		DH AH Y AH AA 
द		DH AH 
तपाईसँग		TH AH P AH AA IH S AHN G AH 
तपाईं लाई कस्तो लाग्यो		TH AH P AH AA IH ML AH AA G  Y AH OH 
डिनर		D AH IH N AH R AH 
टोक्यो।		T AH OH K  Y AH OH 
जीसँग		JH AH IH S AHN G AH 
जाँदैछौँ		JH AH AAN DH AH AH IH CHA AH AH UHN 
छेउको		CHA AH EH UH K AH OH 
चल्दैन।		CH AH L  DH AH AH IH N AH 
गहिरो		G AH HH AH IH R AH OH 
खोल्ने		KA AH OH L  N AH EH 
खोज्नु		KA AH OH JH  N AH UH 
क्लासको		K  L AH AA S AH K AH OH 
कार्डले।		K AH AA R  D AH L AH EH 
कार्डमा		K AH AA R  D AH M AH AA 
कारको		K AH AA R AH K AH OH 
काट्न		K AH AA T  N AH 
कम्पनीमा		K AH M  P AH N AH IH M AH AA 
ककटेल		K AH K AH T AH EH L AH 
एयरपोर्ट		EH Y AH R AH P AH OH R  T AH 
उत्तम।		UH TH  TH AH M AH 
उत्कृष्ट		UH TH  K AH R S  T AH 
आफुलाई		AA PA AH UH L AH AA IH 
आइरहेको		AA IH R AH HH AH EH K AH OH 
अनुभव		AH N AH UH BA AH W AH 
अटाउने		AH T AH AA UH N AH EH 
हुनुहुन्न।		HH AH UH N AH UH HH AH UH N  N AH 
हिउँ		HH AH IH UHN 
सोच्न		S AH OH CH  N AH 
समयतालिका		S AH M AH Y AH TH AH AA L AH IH K AH AA 
सकेन।		S AH K AH EH N AH 
व्यवस्था		W  Y AH W AH S  THA AH AA 
वालेट		W AH AA L AH EH T AH 
लाख		L AH AA KA AH 
लम्बाई		L AH M  B AH AA IH 
रहेछ		R AH HH AH EH CHA AH 
योर्कमा		Y AH OH R  K AH M AH AA 
मेलद्वारा		M AH EH L AH DH  W AH AA R AH AA 
मिनाहा		M AH IH N AH AA HH AH AA 
मास्टर		M AH AA S  T AH R AH 
मरो		M AH R AH OH 
बोकेर		B AH OH K AH EH R AH 
बिना		B AH IH N AH AA 
बिचारमा		B AH IH CH AH AA R AH M AH AA 
फोनबाट		PA AH OH N AH B AH AA T AH 
प्रतिलिपि		P  R AH TH AH IH L AH IH P AH IH 
पच्चिस		P AH CH  CH AH IH S AH 
निस्किन्छ		N AH IH S  K AH IH N  CHA AH 
दिनुसहोस्		DH AH IH N AH UH S AH HH AH OH S  
त्यों		TH  Y AH OH M
त्यहाँ।		TH  Y AH HH AH AAN 
झरालें।		JHA AH R AH AA L AH EH M
जहाजमा		JH AH HH AH AA JH AH M AH AA 
छैनौं।		CHA AH AH IH N AH AH UH M
चिडियाखाना		CH AH IH D AH IH Y AH AA KA AH AA N AH AA 
खानुपर्छ		KA AH AA N AH UH P AH R  CHA AH 
क्याशियर		K  Y AH AA S AH IH Y AH R AH 
कृपया एकै छिन।		K AH R P AH Y AH AA 
किताबहरु		K AH IH TH AH AA B AH HH AH R AH UH 
कसिएको		K AH S AH IH EH K AH OH 
कम्प्याक्ट		K AH M  P  Y AH AA K  T AH 
एसीमा		EH S AH IH M AH AA 
आशामा		AA S AH AA M AH AA 
आर		AA R AH 
आईतबार		AA IH TH AH B AH AA R AH 
आँखामा		AAN KA AH AA M AH AA 
अहिले कति समय भयो		AH HH AH IH L AH EH BA AH Y AH OH 
अमेरिका		AH M AH EH R AH IH K AH AA 
अन्त		AH N  TH AH 
अचानक		AH CH AH AA N AH K AH 
अगस्त		AH G AH S  TH AH 
स्वास्थ्य		S  W AH AA S  THA  Y AH 
स्पष्ट		S  P AH S  T AH 
स्नान		S  N AH AA N AH 
स्कर्ट		S  K AH R  T AH 
सुटकेश		S AH UH T AH K AH EH S AH 
विवरण		W AH IH W AH R AH N AH 
वर्णन		W AH R  N AH N AH 
लन्डन		L AH N  D AH N AH 
रेस्टुरेन्टको		R AH EH S  T AH UH R AH EH N  T AH K AH OH 
राख्नुपर्छ		R AH AA KA  N AH UH P AH R  CHA AH 
येनमा		Y AH EH N AH M AH AA 
मेनू		M AH EH N AH UH 
मेट्रो		M AH EH T  R AH OH 
मूल्यसूचि		M AH UH L  Y AH S AH UH CH AH IH 
मिलाइदिनुहोस्।		M AH IH L AH AA IH DH AH IH N AH UH HH AH OH S  
मिनेटको		M AH IH N AH EH T AH K AH OH 
मार्च		M AH AA R  CH AH 
मदिरा		M AH DH AH IH R AH AA 
भोलीको		BA AH OH L AH IH K AH OH 
भारी		BA AH AA R AH IH 
ब्यूँझाउने		B  Y AH UHN JHA AH AA UH N AH EH 
बिमाको		B AH IH M AH AA K AH OH 
बनाइदिनुहोस्।		B AH N AH AA IH DH AH IH N AH UH HH AH OH S  
फ्लईट		PA  L AH IH T AH 
फुटबल		PA AH UH T AH B AH L AH 
पिज्जा		P AH IH JH  JH AH AA 
पालो		P AH AA L AH OH 
पत्र।		P AH TH  R AH 
पट्टी		P AH T  T AH IH 
नौलो		N AH AH UH L AH OH 
निकाल्न		N AH IH K AH AA L  N AH 
नलिनुहोस्््		N AH L AH IH N AH UH HH AH OH S  
दैनिक		DH AH AH IH N AH IH K AH 
देखी		DH AH EH KA AH IH 
दुबै		DH AH UH B AH AH IH 
दशको		DH AH S AH K AH OH 
दयाको		DH AH Y AH AA K AH OH 
तिर्नुहोस्।		TH AH IH R  N AH UH HH AH OH S  
तिमि		TH AH IH M AH IH 
तारो		TH AH AA R AH OH 
ड्रायर		D  R AH AA Y AH R AH 
ड्राफ्ट		D  R AH AA PA  T AH 
डिपार्टमेन्टल		D AH IH P AH AA R  T AH M AH EH N  T AH L AH 
डाँक		D AH AAN K AH 
डरलाग्दो		D AH R AH L AH AA G  DH AH OH 
टोकन		T AH OH K AH N AH 
टिभि		T AH IH BA AH IH 
जसो		JH AH S AH OH 
जसरी		JH AH S AH R AH IH 
जवान		JH AH W AH AA N AH 
छाता		CHA AH AA TH AH AA 
चौध		CH AH AH UH DHA AH 
चिकित्सकको		CH AH IH K AH IH TH  S AH K AH K AH OH 
चल्नुस्		CH AH L  N AH UH S  
घटाउन		GA AH T AH AA UH N AH 
गरौं		G AH R AH AH UH M
खराबी		KA AH R AH AA B AH IH 
कलर		K AH L AH R AH 
कक्ष		K AH K  S AH 
ओहो।		OH HH AH OH 
ओर्लिन		OH R  L AH IH N AH 
असी		AH S AH IH 
अलिकती		AH L AH IH K AH TH AH IH 
होईन।		HH AH OH IH N AH 
हिल		HH AH IH L AH 
स्कूल		S  K AH UH L AH 
सावर		S AH AA W AH R AH 
साटीदिनुहोला।		S AH AA T AH IH DH AH IH N AH UH HH AH OH L AH AA 
साटि		S AH AA T AH IH 
समुन्द्र		S AH M AH UH N  DH  R AH 
शल्यक्रिया		S AH L  Y AH K  R AH IH Y AH AA 
व्याख्या		W  Y AH AA KA  Y AH AA 
विवाहित		W AH IH W AH AA HH AH IH TH AH 
वटा।		W AH T AH AA 
लेखिदिनुहुन्छ		L AH EH KA AH IH DH AH IH N AH UH HH AH UH N  CHA AH 
लागिरहेको		L AH AA G AH IH R AH HH AH EH K AH OH 
रोचक		R AH OH CH AH K AH 
रिल		R AH IH L AH 
रहनुहोस।		R AH HH AH N AH UH HH AH OH S AH 
युनाइटेड		Y AH UH N AH AA IH T AH EH D AH 
यहीँ		Y AH HH AH IHN 
यती		Y AH TH AH IH 
मिल्दैन		M AH IH L  DH AH AH IH N AH 
मिलाउने		M AH IH L AH AA UH N AH EH 
मिलाईदिन		M AH IH L AH AA IH DH AH IH N AH 
मान्छेको		M AH AA N  CHA AH EH K AH OH 
भइसक्यो।		BA AH IH S AH K  Y AH OH 
ब्ल्यान्केट		B  L  Y AH AA N  K AH EH T AH 
बोर्ड		B AH OH R  D AH 
बिर्सें।		B AH IH R  S AH EH M
बस्दैछु।		B AH S  DH AH AH IH CHA AH UH 
फ्रान्सिस्को		PA  R AH AA N  S AH IH S  K AH OH 
फर्म		PA AH R  M AH 
पिडा		P AH IH D AH AA 
पाँचौ		P AH AAN CH AH AH UH 
परिवार		P AH R AH IH W AH AA R AH 
परिकारहरु		P AH R AH IH K AH AA R AH HH AH R AH UH 
पञ्चट		P AH N  CH AH T AH 
पकाएको		P AH K AH AA EH K AH OH 
नसक्ने		N AH S AH K  N AH EH 
दुईजना		DH AH UH IH JH AH N AH AA 
दिनुपर्छ		DH AH IH N AH UH P AH R  CHA AH 
त्यहिँ		TH  Y AH HH AH IHN 
तिर्नुपर्छ।		TH AH IH R  N AH UH P AH R  CHA AH 
तारेको		TH AH AA R AH EH K AH OH 
तल्लाको		TH AH L  L AH AA K AH OH 
तपाईं के गर्नुहुन्छ		TH AH P AH AA IH M
डिग्री		D AH IH G  R AH IH 
टावर		T AH AA W AH R AH 
जापानीहरु		JH AH AA P AH AA N AH IH HH AH R AH UH 
छोडेछु।		CHA AH OH D AH EH CHA AH UH 
चियर्स।		CH AH IH Y AH R  S AH 
चिकित्सकलाई		CH AH IH K AH IH TH  S AH K AH L AH AA IH 
चाहनु		CH AH AA HH AH N AH UH 
गल्ति		G AH L  TH AH IH 
गर्छौं		G AH R  CHA AH AH UH M
गरे।		G AH R AH EH 
गरिराखेको		G AH R AH IH R AH AA KA AH EH K AH OH 
खोल		KA AH OH L AH 
खासै		KA AH AA S AH AH IH 
खानाहरु		KA AH AA N AH AA HH AH R AH UH 
कोर्न		K AH OH R  N AH 
के भन्न खोज्नु भएको		K AH EH BA AH EH K AH OH 
कक्षा		K AH K  S AH AA 
एक्स		EH K  S AH 
एकचोटि		EH K AH CH AH OH T AH IH 
ई		IH 
आफु		AA PA AH UH 
आउनेछु।		AA UH N AH EH CHA AH UH 
आउँ		AA UHN 
अमेरिकाको		AH M AH EH R AH IH K AH AA K AH OH 
अड्डा		AH D  D AH AA 
होटलसम्म		HH AH OH T AH L AH S AH M  M AH 
हेर्नु		HH AH EH R  N AH UH 
हिसाबको		HH AH IH S AH AA B AH K AH OH 
हलुका		HH AH L AH UH K AH AA 
सुन्नियो।		S AH UH N  N AH IH Y AH OH 
समुद्र		S AH M AH UH DH  R AH 
सजिलैसँग		S AH JH AH IH L AH AH IH S AHN G AH 
सके		S AH K AH EH 
वास्तवमै		W AH AA S  TH AH W AH M AH AH IH 
लक्षण		L AH K  S AH N AH 
रोक।		R AH OH K AH 
मुल्यमा		M AH UH L  Y AH M AH AA 
मिलाउनुहोस्।		M AH IH L AH AA UH N AH UH HH AH OH S  
भुक्तानी		BA AH UH K  TH AH AA N AH IH 
भात		BA AH AA TH AH 
भाडाको		BA AH AA D AH AA K AH OH 
ब्यागेज		B  Y AH AA G AH EH JH AH 
फर्काउन		PA AH R  K AH AA UH N AH 
प्लेटफर्म		P  L AH EH T AH PA AH R  M AH 
पोष्टकार्ड		P AH OH S  T AH K AH AA R  D AH 
पुष्टि		P AH UH S  T AH IH 
पकाउन चाहनुहुन्छ		P AH K AH AA UH N AH 
धुलाउन		DHA AH UH L AH AA UH N AH 
दिशामा		DH AH IH S AH AA M AH AA 
तिर।		TH AH IH R AH 
तपाइले		TH AH P AH AA IH L AH EH 
ढोकामा		DA AH OH K AH AA M AH AA 
डुंगा		D AH UH MG AH AA 
टोपी		T AH OH P AH IH 
टेप		T AH EH P AH 
टाउन		T AH AA UH N AH 
छौ		CHA AH AH UH 
छू।		CHA AH UH 
छुट्टी		CHA AH UH T  T AH IH 
चस्मा		CH AH S  M AH AA 
गते		G AH TH AH EH 
खरिद		KA AH R AH IH DH AH 
एलर्जीहरु		EH L AH R  JH AH IH HH AH R AH UH 
एकसय		EH K AH S AH Y AH 
एकतर्फी		EH K AH TH AH R  PA AH IH 
उठाउनुहोस्।		UH TA AH AA UH N AH UH HH AH OH S  
आमाको		AA M AH AA K AH OH 
आपत्काल		AA P AH TH  K AH AA L AH 
आउँनसक्छु		AA UHN N AH S AH K  CHA AH UH 
असर		AH S AH R AH 
अप		AH P AH 
हैन।		HH AH AH IH N AH 
हालेर		HH AH AA L AH EH R AH 
हार		HH AH AA R AH 
हातमा		HH AH AA TH AH M AH AA 
हवाईमेलबाट		HH AH W AH AA IH M AH EH L AH B AH AA T AH 
स्पेशल		S  P AH EH S AH L AH 
स्टेशनको		S  T AH EH S AH N AH K AH OH 
स्टाइल		S  T AH AA IH L AH 
सहयोगको		S AH HH AH Y AH OH G AH K AH OH 
सधै		S AH DHA AH AH IH 
शुभकामनाहरु।		S AH UH BA AH K AH AA M AH N AH AA HH AH R AH UH 
विधार्थी		W AH IH DHA AH AA R  THA AH IH 
वाकवाक		W AH AA K AH W AH AA K AH 
ल्याइदिन		L  Y AH AA IH DH AH IH N AH 
लुगाधुने		L AH UH G AH AA DHA AH UH N AH EH 
ला।		L AH AA 
लाग्नेछ।		L AH AA G  N AH EH CHA AH 
लगाउँ		L AH G AH AA UHN 
रोकडमा		R AH OH K AH D AH M AH AA 
यो।		Y AH OH 
यिनीहरुलाई		Y AH IH N AH IH HH AH R AH UH L AH AA IH 
मनाही		M AH N AH AA HH AH IH 
भईरहेको		BA AH IH R AH HH AH EH K AH OH 
बेहोस		B AH EH HH AH OH S AH 
बुकिंग		B AH UH K AH IH MG AH 
बताइदिनुहुन्छ		B AH TH AH AA IH DH AH IH N AH UH HH AH UH N  CHA AH 
प्रकारका		P  R AH K AH AA R AH K AH AA 
पेरिस		P AH EH R AH IH S AH 
पार्ने		P AH AA R  N AH EH 
पाउन्ड		P AH AA UH N  D AH 
पर्मानेन्ट		P AH R  M AH AA N AH EH N  T AH 
पर्दा		P AH R  DH AH AA 
पट्टि		P AH T  T AH IH 
निस्किने		N AH IH S  K AH IH N AH EH 
निर		N AH IH R AH 
दिनसक्छु		DH AH IH N AH S AH K  CHA AH UH 
थुप्रै		THA AH UH P  R AH AH IH 
थिए		THA AH IH EH 
तौलिया		TH AH AH UH L AH IH Y AH AA 
डेल्टा		D AH EH L  T AH AA 
टिम		T AH IH M AH 
टिकट।		T AH IH K AH T AH 
जोरो		JH AH OH R AH OH 
जिन्स		JH AH IH N  S AH 
चौबीस		CH AH AH UH B AH IH S AH 
ग्रान्ड		G  R AH AA N  D AH 
गर्नुहुन्न		G AH R  N AH UH HH AH UH N  N AH 
गर्नका		G AH R  N AH K AH AA 
गर्दैनौं।		G AH R  DH AH AH IH N AH AH UH M
क्यासिनो		K  Y AH AA S AH IH N AH OH 
कुर्नु		K AH UH R  N AH UH 
कामदार।		K AH AA M AH DH AH AA R AH 
कहाँको		K AH HH AH AAN K AH OH 
उहाँहरू		UH HH AH AAN HH AH R AH UH 
उजुरी		UH JH AH UH R AH IH 
इकोनोमी		IH K AH OH N AH OH M AH IH 
आउला		AA UH L AH AA 
अफिसर।		AH PA AH IH S AH R AH 
हेर्नुहोस्		HH AH EH R  N AH UH HH AH OH S  
हिंड्न		HH AH IH MD  N AH 
हाल्ने		HH AH AA L  N AH EH 
हप्तामा		HH AH P  TH AH AA M AH AA 
सोचेको		S AH OH CH AH EH K AH OH 
सुपरमार्केट		S AH UH P AH R AH M AH AA R  K AH EH T AH 
सीधै		S AH IH DHA AH AH IH 
साथमा		S AH AA THA AH M AH AA 
साट्नुहोस्।		S AH AA T  N AH UH HH AH OH S  
सागुँरो		S AH AA G AH UHN R AH OH 
सकेको		S AH K AH EH K AH OH 
शुभनाम		S AH UH BA AH N AH AA M AH 
शिकागोको		S AH IH K AH AA G AH OH K AH OH 
शर्ट		S AH R  T AH 
व्यापारिक		W  Y AH AA P AH AA R AH IH K AH 
वरपर		W AH R AH P AH R AH 
लोकप्रीय		L AH OH K AH P  R AH IH Y AH 
लुटियो।		L AH UH T AH IH Y AH OH 
रेलको		R AH EH L AH K AH OH 
रगतटाइप		R AH G AH TH AH T AH AA IH P AH 
रंगिन		R AH MG AH IH N AH 
रंगहरुमा		R AH MG AH HH AH R AH UH M AH AA 
यसरी		Y AH S AH R AH IH 
मोड्मा		M AH OH D  M AH AA 
मार्गबाट।		M AH AA R  G AH B AH AA T AH 
ब्यबस्था		B  Y AH B AH S  THA AH AA 
बोर्डिङ्ग		B AH OH R  D AH IH NG  G AH 
बेल		B AH EH L AH 
बेरिदिनुहोस्।		B AH EH R AH IH DH AH IH N AH UH HH AH OH S  
बिसौनीमा		B AH IH S AH AH UH N AH IH M AH AA 
बस।		B AH S AH 
बदल्नसक्छु		B AH DH AH L  N AH S AH K  CHA AH UH 
प्लाजा		P  L AH AA JH AH AA 
पुगेपछि		P AH UH G AH EH P AH CHA AH IH 
पार्किङ		P AH AA R  K AH IH NG AH 
पारि		P AH AA R AH IH 
पर्न		P AH R  N AH 
धेरैजसो		DHA AH EH R AH AH IH JH AH S AH OH 
द्वार		DH  W AH AA R AH 
दाबी		DH AH AA B AH IH 
दशवटा		DH AH S AH W AH T AH AA 
तीन।		TH AH IH N AH 
तयारी		TH AH Y AH AA R AH IH 
तपाईं अण्डा कसरी		TH AH P AH AA IH M
तथा		TH AH THA AH AA 
ढुवानी		DA AH UH W AH AA N AH IH 
डाक्टरले		D AH AA K  T AH R AH L AH EH 
टेलिभिजन		T AH EH L AH IH BA AH IH JH AH N AH 
टाँक		T AH AAN K AH 
टर्च		T AH R  CH AH 
जापानीमा		JH AH AA P AH AA N AH IH M AH AA 
जहिले		JH AH HH AH IH L AH EH 
चिन्तित		CH AH IH N  TH AH IH TH AH 
गिंलास		G AH IH ML AH AA S AH 
गर्दैन।		G AH R  DH AH AH IH N AH 
कि।		K AH IH 
कारणले		K AH AA R AH N AH L AH EH 
काटेर		K AH AA T AH EH R AH 
कफी।		K AH PA AH IH 
उनीहरु		UH N AH IH HH AH R AH UH 
इटालियन		IH T AH AA L AH IH Y AH N AH 
आकास्मिक		AA K AH AA S  M AH IH K AH 
आकर्षक		AA K AH R  S AH K AH 
हेर्दा		HH AH EH R  DH AH AA 
हेरिदिनुहोस्।		HH AH EH R AH IH DH AH IH N AH UH HH AH OH S  
स्वादिष्ट		S  W AH AA DH AH IH S  T AH 
स्मिस		S  M AH IH S AH 
सेल		S AH EH L AH 
सुहाउँछ		S AH UH HH AH AA UHN CHA AH 
सुविधा		S AH UH W AH IH DHA AH AA 
सुरक्षा		S AH UH R AH K  S AH AA 
सुपर		S AH UH P AH R AH 
सामानहरू		S AH AA M AH AA N AH HH AH R AH UH 
सात।		S AH AA TH AH 
सर्वीस		S AH R  W AH IH S AH 
सबैलाई		S AH B AH AH IH L AH AA IH 
शुद्ध		S AH UH DH  DHA AH 
विषय		W AH IH S AH Y AH 
लिई		L AH IH IH 
लागिकोसेली		L AH AA G AH IH K AH OH S AH EH L AH IH 
रोस्ट		R AH OH S  T AH 
रोग		R AH OH G AH 
मुल्यवान		M AH UH L  Y AH W AH AA N AH 
मिलाइदिनु		M AH IH L AH AA IH DH AH IH N AH UH 
मसित		M AH S AH IH TH AH 
मर्कियो।		M AH R  K AH IH Y AH OH 
भीड		BA AH IH D AH 
भावनाको		BA AH AA W AH N AH AA K AH OH 
भाँचिएको		BA AH AAN CH AH IH EH K AH OH 
बित्तिकै		B AH IH TH  TH AH IH K AH AH IH 
बाथरुम		B AH AA THA AH R AH UH M AH 
बदल्न		B AH DH AH L  N AH 
बताउन		B AH TH AH AA UH N AH 
फुल		PA AH UH L AH 
फिल्मको		PA AH IH L  M AH K AH OH 
फर्किन्छु।		PA AH R  K AH IH N  CHA AH UH 
प्राथमिक		P  R AH AA THA AH M AH IH K AH 
पुष्टिकरण		P AH UH S  T AH IH K AH R AH N AH 
पुग्नु		P AH UH G  N AH UH 
पीडा		P AH IH D AH AA 
पिएको		P AH IH EH K AH OH 
पि		P AH IH 
परेकोमा		P AH R AH EH K AH OH M AH AA 
परें।		P AH R AH EH M
पठाएको		P AH TA AH AA EH K AH OH 
निर्माण		N AH IH R  M AH AA N AH 
नापको		N AH AA P AH K AH OH 
नाटक कति बेला सुरू हुन्छ		N AH AA T AH K AH S AH UH R AH UH 
नाच्न		N AH AA CH  N AH 
नलगाउनूहोस।		N AH L AH G AH AA UH N AH UH HH AH OH S AH 
नदुख्ने		N AH DH AH UH KA  N AH EH 
नगरिदिनुहोला।		N AH G AH R AH IH DH AH IH N AH UH HH AH OH L AH AA 
धूम्रपान		DHA AH UH M  R AH P AH AA N AH 
द्वारा।		DH  W AH AA R AH AA 
दिनुभयो।		DH AH IH N AH UH BA AH Y AH OH 
तल्लो		TH AH L  L AH OH 
तपाईंकहाँ		TH AH P AH AA IH MK AH HH AH AAN 
जी।		JH AH IH 
जाल		JH AH AA L AH 
चर्च		CH AH R  CH AH 
गर्नलाई		G AH R  N AH L AH AA IH 
गर्दैछौँ।		G AH R  DH AH AH IH CHA AH AH UHN 
खुसि		KA AH UH S AH IH 
क्षमा		K  S AH M AH AA 
कोठाहरू		K AH OH TA AH AA HH AH R AH UH 
कोकाकोला		K AH OH K AH AA K AH OH L AH AA 
कुनबाटो		K AH UH N AH B AH AA T AH OH 
काँहा		K AH AAN HH AH AA 
कर्मचारी		K AH R  M AH CH AH AA R AH IH 
करीब		K AH R AH IH B AH 
कम्तिमा		K AH M  TH AH IH M AH AA 
ऐतिहासिक		AH IH TH AH IH HH AH AA S AH IH K AH 
अखबारहरु		AH KA AH B AH AA R AH HH AH R AH UH 
होटेलसम्म		HH AH OH T AH EH L AH S AH M  M AH 
हेर्दैछु		HH AH EH R  DH AH AH IH CHA AH UH 
हुनहुन्छ		HH AH UH N AH HH AH UH N  CHA AH 
हस।		HH AH S AH 
सित्तैमा		S AH IH TH  TH AH AH IH M AH AA 
सान्		S AH AA N  
सातको		S AH AA TH AH K AH OH 
सक्यो		S AH K  Y AH OH 
संधै		S AH MDHA AH AH IH 
शाखा		S AH AA KA AH AA 
व्यक्तिलाई		W  Y AH K  TH AH IH L AH AA IH 
वजन		W AH JH AH N AH 
लिनको		L AH IH N AH K AH OH 
रोकिन्छौं		R AH OH K AH IH N  CHA AH AH UH M
रेयरमा		R AH EH Y AH R AH M AH AA 
रजिस्टर		R AH JH AH IH S  T AH R AH 
रक्सीको		R AH K  S AH IH K AH OH 
योकोठा		Y AH OH K AH OH TA AH AA 
येसकोबारे		Y AH EH S AH K AH OH B AH AA R AH EH 
यू		Y AH UH 
यहीं		Y AH HH AH IH M
मसंग		M AH S AH MG AH 
मनपर्यो।		M AH N AH P AH R  Y AH OH 
भनिदिन		BA AH N AH IH DH AH IH N AH 
भंसार		BA AH MS AH AA R AH 
बोलाउनु		B AH OH L AH AA UH N AH UH 
बोलाईदिन		B AH OH L AH AA IH DH AH IH N AH 
बैंकमा		B AH AH IH MK AH M AH AA 
बिर्सिएँ।		B AH IH R  S AH IH EHN 
बहिरहन्छ।		B AH HH AH IH R AH HH AH N  CHA AH 
फुर्सद		PA AH UH R  S AH DH AH 
फुर्सत		PA AH UH R  S AH TH AH 
फुकाल्नुहोस्।		PA AH UH K AH AA L  N AH UH HH AH OH S  
पोका		P AH OH K AH AA 
पैसामा		P AH AH IH S AH AA M AH AA 
पैंतीस		P AH AH IH MTH AH IH S AH 
पानीजहाज		P AH AA N AH IH JH AH HH AH AA JH AH 
पाँचमा		P AH AAN CH AH M AH AA 
पलंग		P AH L AH MG AH 
पर्यटन		P AH R  Y AH T AH N AH 
पर्खन		P AH R  KA AH N AH 
पत्रिकहरू		P AH TH  R AH IH K AH HH AH R AH UH 
पत्थर		P AH TH  THA AH R AH 
नहुने		N AH HH AH UH N AH EH 
नजीकैको		N AH JH AH IH K AH AH IH K AH OH 
दूध		DH AH UH DHA AH 
थकित		THA AH K AH IH TH AH 
तिर्खा		TH AH IH R  KA AH AA 
तिरिसकें।		TH AH IH R AH IH S AH K AH EH M
तरिकाले		TH AH R AH IH K AH AA L AH EH 
तपाईंका		TH AH P AH AA IH MK AH AA 
तपाइको		TH AH P AH AA IH K AH OH 
डेस्क		D AH EH S  K AH 
ठिक्कको		TA AH IH K  K AH K AH OH 
ठाऊँमा		TA AH AA UHN M AH AA 
जवाफ		JH AH W AH AA PA AH 
छत्तिस		CHA AH TH  TH AH IH S AH 
चाही		CH AH AA HH AH IH 
चढाइदिनुहोला।		CH AH DA AH AA IH DH AH IH N AH UH HH AH OH L AH AA 
घण्टा।		GA AH N  T AH AA 
खुशीको		KA AH UH S AH IH K AH OH 
खली		KA AH L AH IH 
क्षमाप्रार्थी		K  S AH M AH AA P  R AH AA R  THA AH IH 
कार्ड।		K AH AA R  D AH 
कार्डहरु		K AH AA R  D AH HH AH R AH UH 
कहिलेदेखि		K AH HH AH IH L AH EH DH AH EH KA AH IH 
कफि		K AH PA AH IH 
एफ		EH PA AH 
एकमा		EH K AH M AH AA 
उसिनेको		UH S AH IH N AH EH K AH OH 
उपयुक्त		UH P AH Y AH UH K  TH AH 
इन्च		IH N  CH AH 
इचिरो		IH CH AH IH R AH OH 
आफ्ना		AA PA  N AH AA 
आउँदैछ।		AA UHN DH AH AH IH CHA AH 
आईपुग्छौं		AA IH P AH UH G  CHA AH AH UH M
आइल		AA IH L AH 
अगाडी।		AH G AH AA D AH IH 
हे		HH AH EH 
हाम्रा		HH AH AA M  R AH AA 
हामीसँगै		HH AH AA M AH IH S AHN G AH AH IH 
हामि		HH AH AA M AH IH 
हाते		HH AH AA TH AH EH 
हरू		HH AH R AH UH 
स्मारिका		S  M AH AA R AH IH K AH AA 
स्क्वेर		S  K  W AH EH R AH 
सोच्ने		S AH OH CH  N AH EH 
सोख		S AH OH KA AH 
सो		S AH OH 
सेफ्टी		S AH EH PA  T AH IH 
सेक्नुहोस।		S AH EH K  N AH UH HH AH OH S AH 
सुन्नुहोस्		S AH UH N  N AH UH HH AH OH S  
सिंगान		S AH IH MG AH AA N AH 
साठी		S AH AA TA AH IH 
सर्		S AH R  
समातेर		S AH M AH AA TH AH EH R AH 
सबवेको		S AH B AH W AH EH K AH OH 
सटहि		S AH T AH HH AH IH 
शाखामा		S AH AA KA AH AA M AH AA 
लिपस्टिक		L AH IH P AH S  T AH IH K AH 
लिउँ		L AH IH UHN 
रेलबाट		R AH EH L AH B AH AA T AH 
राख्दिन		R AH AA KA  DH AH IH N AH 
रमाउँछु।		R AH M AH AA UHN CHA AH UH 
म्		M  
मिठाई		M AH IH TA AH AA IH 
मार्गको		M AH AA R  G AH K AH OH 
महंगो		M AH HH AH MG AH OH 
मसालेदार		M AH S AH AA L AH EH DH AH AA R AH 
भनिन्छ।		BA AH N AH IH N  CHA AH 
बोल्दिन।		B AH OH L  DH AH IH N AH 
बेर्नसक्नुहुन्छ		B AH EH R  N AH S AH K  N AH UH HH AH UH N  CHA AH 
बाथरूम		B AH AA THA AH R AH UH M AH 
बनाई		B AH N AH AA IH 
पाहिले		P AH AA HH AH IH L AH EH 
पाकेको		P AH AA K AH EH K AH OH 
पाए		P AH AA EH 
पाँच।		P AH AAN CH AH 
पर्ची		P AH R  CH AH IH 
पर्खिदिनुहुन्छ		P AH R  KA AH IH DH AH IH N AH UH HH AH UH N  CHA AH 
पंग्चर		P AH MG  CH AH R AH 
नीलो		N AH IH L AH OH 
निस्कन		N AH IH S  K AH N AH 
नक्कली		N AH K  K AH L AH IH 
दुइवटा		DH AH UH IH W AH T AH AA 
दिनुभयो		DH AH IH N AH UH BA AH Y AH OH 
दश्तखत		DH AH S  TH AH KA AH TH AH 
थाहाछैन।		THA AH AA HH AH AA CHA AH AH IH N AH 
थप्नुहोस्।		THA AH P  N AH UH HH AH OH S  
तिनी		TH AH IH N AH IH 
तला		TH AH L AH AA 
तर्फबाट		TH AH R  PA AH B AH AA T AH 
ठोक्काएँ।		TA AH OH K  K AH AA EHN 
टानका		T AH AA N AH K AH AA 
झ्यालपट्टिको		JHA  Y AH AA L AH P AH T  T AH IH K AH OH 
झोलाको		JHA AH OH L AH AA K AH OH 
जो		JH AH OH 
जिन		JH AH IH N AH 
जाना		JH AH AA N AH AA 
जहाजबाट		JH AH HH AH AA JH AH B AH AA T AH 
छोरी		CHA AH OH R AH IH 
गिलासमा		G AH IH L AH AA S AH M AH AA 
गरें		G AH R AH EH M
खेल्नुहुन्छ		KA AH EH L  N AH UH HH AH UH N  CHA AH 
खेलको		KA AH EH L AH K AH OH 
खाटमा		KA AH AA T AH M AH AA 
कोशिश		K AH OH S AH IH S AH 
केही।		K AH EH HH AH IH 
कृपया एकै छिन पर्खनसक्नुहुन्छ		K AH R P AH Y AH AA P AH R  KA AH N AH S AH K  N AH UH HH AH UH N  CHA AH 
की।		K AH IH 
कार्टुन		K AH AA R  T AH UH N AH 
काट्ने		K AH AA T  N AH EH 
काटियो।		K AH AA T AH IH Y AH OH 
कसिलो		K AH S AH IH L AH OH 
एयरलाइन्सको		EH Y AH R AH L AH AA IH N  S AH K AH OH 
एक।		EH K AH 
उनले		UH N AH L AH EH 
उज्यालो		UH JH  Y AH AA L AH OH 
इन्जिन		IH N  JH AH IH N AH 
आन्जलस		AA N  JH AH L AH S AH 
आधुनिक		AA DHA AH UH N AH IH K AH 
आजरातिको		AA JH AH R AH AA TH AH IH K AH OH 
आइस		AA IH S AH 
आइतवार		AA IH TH AH W AH AA R AH 
अवस्था		AH W AH S  THA AH AA 
अध्यागमन		AH DHA  Y AH AA G AH M AH N AH 
अघिल्लो		AH GA AH IH L  L AH OH 
सोह्र		S AH OH HH  R AH 
सोहो		S AH OH HH AH OH 
सुजुकि		S AH UH JH AH UH K AH IH 
सार्वजानिक		S AH AA R  W AH JH AH AA N AH IH K AH 
साइट्सिइङ्ग		S AH AA IH T  S AH IH IH NG  G AH 
सफ्ट		S AH PA  T AH 
सङ्गीत		S AH NG  G AH IH TH AH 
शोख		S AH OH KA AH 
व्यवसाय		W  Y AH W AH S AH AA Y AH 
विमानस्थलको		W AH IH M AH AA N AH S  THA AH L AH K AH OH 
वास्ता		W AH AA S  TH AH AA 
लोशन		L AH OH S AH N AH 
लेबुल		L AH EH B AH UH L AH 
लागेको।		L AH AA G AH EH K AH OH 
लबीमा		L AH B AH IH M AH AA 
रेलहरु		R AH EH L AH HH AH R AH UH 
राजदूतावास		R AH AA JH AH DH AH UH TH AH AA W AH AA S AH 
रख्नुहोस्।		R AH KA  N AH UH HH AH OH S  
येन।		Y AH EH N AH 
यहाँँबाट		Y AH HH AH AAN N B AH AA T AH 
मिडियम		M AH IH D AH IH Y AH M AH 
महिनामा		M AH HH AH IH N AH AA M AH AA 
महत्वपूर्ण		M AH HH AH TH  W AH P AH UH R  N AH 
मर्काएँ।		M AH R  K AH AA EHN 
भेतेर		BA AH EH TH AH EH R AH 
भित्रै		BA AH IH TH  R AH AH IH 
भएमा		BA AH EH M AH AA 
बैंकको		B AH AH IH MK AH K AH OH 
बेलुकी		B AH EH L AH UH K AH IH 
बिषयमा		B AH IH S AH Y AH M AH AA 
बाथ		B AH AA THA AH 
बजिरहेको		B AH JH AH IH R AH HH AH EH K AH OH 
फुट्ने		PA AH UH T  N AH EH 
फर्किन्छ		PA AH R  K AH IH N  CHA AH 
पीडित		P AH IH D AH IH TH AH 
पारिदिनुहोस्।		P AH AA R AH IH DH AH IH N AH UH HH AH OH S  
पांच		P AH AA MCH AH 
पर्खनु		P AH R  KA AH N AH UH 
पठाई		P AH TA AH AA IH 
पचहत्तर		P AH CH AH HH AH TH  TH AH R AH 
निर्देशन		N AH IH R  DH AH EH S AH N AH 
नङ		N AH NG AH 
धुनुपर्ने		DHA AH UH N AH UH P AH R  N AH EH 
देखाउने		DH AH EH KA AH AA UH N AH EH 
दिनुहोला		DH AH IH N AH UH HH AH OH L AH AA 
ताल		TH AH AA L AH 
तरकारी		TH AH R AH K AH AA R AH IH 
डाइनिङ्ग		D AH AA IH N AH IH NG  G AH 
ट्वीन		T  W AH IH N AH 
टोक्यो		T AH OH K  Y AH OH 
टोकनको		T AH OH K AH N AH K AH OH 
टूरमा		T AH UH R AH M AH AA 
टिभी		T AH IH BA AH IH 
झिक्न		JHA AH IH K  N AH 
झालपट्टि		JHA AH AA L AH P AH T  T AH IH 
जापानसम्म		JH AH AA P AH AA N AH S AH M  M AH 
जाँचको		JH AH AAN CH AH K AH OH 
छुट्ने		CHA AH UH T  N AH EH 
छुट्छ।		CHA AH UH T  CHA AH 
छीटो		CHA AH IH T AH OH 
चढ्नुहोस्।		CH AH DA  N AH UH HH AH OH S  
चकलेट		CH AH K AH L AH EH T AH 
गर्दिनुहोस्।		G AH R  DH AH IH N AH UH HH AH OH S  
ख्याल		KA  Y AH AA L AH 
क्षमता		K  S AH M AH TH AH AA 
क्षतिपूर्ति		K  S AH TH AH IH P AH UH R  TH AH IH 
कुरा।		K AH UH R AH AA 
कलाकार		K AH L AH AA K AH AA R AH 
कम्		K AH M  
कपालमा		K AH P AH AA L AH M AH AA 
कटाउन		K AH T AH AA UH N AH 
औषधिहरु		AH UN S AH DHA AH IH HH AH R AH UH 
औँला		AH UNN L AH AA 
एउटाको		EH UH T AH AA K AH OH 
उमेर		UH M AH EH R AH 
उपकरण		UH P AH K AH R AH N AH 
उन्नाइस		UH N  N AH AA IH S AH 
उनीहरुले		UH N AH IH HH AH R AH UH L AH EH 
आसपास		AA S AH P AH AA S AH 
आमा		AA M AH AA 
आउदैन।		AA UH DH AH AH IH N AH 
आईपुग्छु।		AA IH P AH UH G  CHA AH UH 
अफिसमा		AH PA AH IH S AH M AH AA 
ह्वाइट		HH  W AH AA IH T AH 
होटलबाट		HH AH OH T AH L AH B AH AA T AH 
हुनुभएको		HH AH UH N AH UH BA AH EH K AH OH 
हुँदैछ		HH AH UHN DH AH AH IH CHA AH 
हुँदा		HH AH UHN DH AH AA 
हाल्नुहोस्।		HH AH AA L  N AH UH HH AH OH S  
हामीसंग		HH AH AA M AH IH S AH MG AH 
सेप्टेम्बर		S AH EH P  T AH EH M  B AH R AH 
सुत्नै		S AH UH TH  N AH AH IH 
सकिएको		S AH K AH IH EH K AH OH 
शायद		S AH AA Y AH DH AH 
ल्यादिनुहोस्।		L  Y AH AA DH AH IH N AH UH HH AH OH S  
लुगाको		L AH UH G AH AA K AH OH 
लाग्दो		L AH AA G  DH AH OH 
रोकिंदैन।		R AH OH K AH IH MDH AH AH IH N AH 
रूपमा		R AH UH P AH M AH AA 
रुपैया		R AH UH P AH AH IH Y AH AA 
राखुँ		R AH AA KA AH UHN 
राखी		R AH AA KA AH IH 
राकेट		R AH AA K AH EH T AH 
मिनेटमा।		M AH IH N AH EH T AH M AH AA 
मिटरभन्दा		M AH IH T AH R AH BA AH N  DH AH AA 
मार्ने		M AH AA R  N AH EH 
मार्केट		M AH AA R  K AH EH T AH 
मानिसहरु		M AH AA N AH IH S AH HH AH R AH UH 
मानिस		M AH AA N AH IH S AH 
महोदय		M AH HH AH OH DH AH Y AH 
भेटौला।		BA AH EH T AH AH UH L AH AA 
भाँचे।		BA AH AAN CH AH EH 
भए।		BA AH EH 
ब्रोडवे		B  R AH OH D AH W AH EH 
बोलाउनुभएको		B AH OH L AH AA UH N AH UH BA AH EH K AH OH 
बिलको		B AH IH L AH K AH OH 
बिदेशी		B AH IH DH AH EH S AH IH 
बिक्रीमा		B AH IH K  R AH IH M AH AA 
बहुमूल्य		B AH HH AH UH M AH UH L  Y AH 
बसाई		B AH S AH AA IH 
बराबर		B AH R AH AA B AH R AH 
बटर		B AH T AH R AH 
फराकिलो		PA AH R AH AA K AH IH L AH OH 
प्रिन्ट		P  R AH IH N  T AH 
पेट्रोलको		P AH EH T  R AH OH L AH K AH OH 
पानीमा		P AH AA N AH IH M AH AA 
पाउँ		P AH AA UHN 
पर्खँदैछु।		P AH R  KA AHN DH AH AH IH CHA AH UH 
पट्टिको		P AH T  T AH IH K AH OH 
पछि।		P AH CHA AH IH 
निस्किन्छु।		N AH IH S  K AH IH N  CHA AH UH 
नगर		N AH G AH R AH 
देखिएको		DH AH EH KA AH IH EH K AH OH 
देखाउँछु।		DH AH EH KA AH AA UHN CHA AH UH 
थिईन।		THA AH IH IH N AH 
थकाइ		THA AH K AH AA IH 
त्यहाँबाट		TH  Y AH HH AH AAN B AH AA T AH 
तेह्र		TH AH EH HH  R AH 
तीर		TH AH IH R AH 
ढीलो		DA AH IH L AH OH 
ट्रान्जिट		T  R AH AA N  JH AH IH T AH 
ज्याज		JH  Y AH AA JH AH 
जाँच्नुहोला।		JH AH AAN CH  N AH UH HH AH OH L AH AA 
जन्मदिन		JH AH N  M AH DH AH IH N AH 
जकेट		JH AH K AH EH T AH 
छोडे		CHA AH OH D AH EH 
छै		CHA AH AH IH 
चोर		CH AH OH R AH 
चाहन्न।		CH AH AA HH AH N  N AH 
घामले		GA AH AA M AH L AH EH 
घटाउनु		GA AH T AH AA UH N AH UH 
गीत		G AH IH TH AH 
गलती		G AH L AH TH AH IH 
गरिन्छ		G AH R AH IH N  CHA AH 
गरिदिन्छु।		G AH R AH IH DH AH IH N  CHA AH UH 
गएँ।		G AH EHN 
खेलहरु		KA AH EH L AH HH AH R AH UH 
किन्नु		K AH IH N  N AH UH 
किने		K AH IH N AH EH 
कार्य		K AH AA R  Y AH 
कारहरु		K AH AA R AH HH AH R AH UH 
कारमा		K AH AA R AH M AH AA 
काट्नुहोस्		K AH AA T  N AH UH HH AH OH S  
काटेको		K AH AA T AH EH K AH OH 
कागजको		K AH AA G AH JH AH K AH OH 
कक्टेल		K AH K  T AH EH L AH 
औँठी		AH UNN TA AH IH 
ओसाका		OH S AH AA K AH AA 
उडिन्छ		UH D AH IH N  CHA AH 
उठाउन		UH TA AH AA UH N AH 
आँखाको		AAN KA AH AA K AH OH 
अभिनेता		AH BA AH IH N AH EH TH AH AA 
अनुमान		AH N AH UH M AH AA N AH 
अक्टोबर		AH K  T AH OH B AH R AH 
हुनुहोस्।		HH AH UH N AH UH HH AH OH S  
स्वेटर		S  W AH EH T AH R AH 
स्थान		S  THA AH AA N AH 
स्थलमा		S  THA AH L AH M AH AA 
स्ट्रिटमा		S  T  R AH IH T AH M AH AA 
सुहाउने		S AH UH HH AH AA UH N AH EH 
सामाग्री		S AH AA M AH AA G  R AH IH 
सम्झिन		S AH M  JHA AH IH N AH 
शुभकामना		S AH UH BA AH K AH AA M AH N AH AA 
विस्तारै		W AH IH S  TH AH AA R AH AH IH 
वाल		W AH AA L AH 
ल्याउँ		L  Y AH AA UHN 
ल्याइदुनुस्		L  Y AH AA IH DH AH UH N AH UH S  
लिनुपर्छ।		L AH IH N AH UH P AH R  CHA AH 
लाइनको		L AH AA IH N AH K AH OH 
रसीद।		R AH S AH IH DH AH 
रङ्ग		R AH NG  G AH 
यात्रुहरु		Y AH AA TH  R AH UH HH AH R AH UH 
यहाँँ		Y AH HH AH AAN N 
म्यारी		M  Y AH AA R AH IH 
म्यानेजर		M  Y AH AA N AH EH JH AH R AH 
मोड्नुस्		M AH OH D  N AH UH S  
मेसिन		M AH EH S AH IH N AH 
माइल		M AH AA IH L AH 
मरिच		M AH R AH IH CH AH 
भिड		BA AH IH D AH 
भरेको		BA AH R AH EH K AH OH 
ब्लाउज		B  L AH AA UH JH AH 
ब्राउन		B  R AH AA UH N AH 
ब्यूझाउने		B  Y AH UH JHA AH AA UH N AH EH 
ब्यागहरु		B  Y AH AA G AH HH AH R AH UH 
बोटल		B AH OH T AH L AH 
बेरमा		B AH EH R AH M AH AA 
बुझ्नुभयो		B AH UH JHA  N AH UH BA AH Y AH OH 
बिषय		B AH IH S AH Y AH 
बिमानस्थलमा		B AH IH M AH AA N AH S  THA AH L AH M AH AA 
बित्यो।		B AH IH TH  Y AH OH 
बस्नसक्छु		B AH S  N AH S AH K  CHA AH UH 
बयान		B AH Y AH AA N AH 
बन्ध		B AH N  DHA AH 
बदल्ने		B AH DH AH L  N AH EH 
बक्शीश		B AH K  S AH IH S AH 
फोनहरु		PA AH OH N AH HH AH R AH UH 
फर्कनुहुन्छ		PA AH R  K AH N AH UH HH AH UH N  CHA AH 
फर्कन		PA AH R  K AH N AH 
पुतली		P AH UH TH AH L AH IH 
पासपोर्ट।		P AH AA S AH P AH OH R  T AH 
पालिस		P AH AA L AH IH S AH 
पार्कको		P AH AA R  K AH K AH OH 
पाकेट		P AH AA K AH EH T AH 
पल्ट		P AH L  T AH 
पर्चा		P AH R  CH AH AA 
परेन।		P AH R AH EH N AH 
निजीका		N AH IH JH AH IH K AH AA 
नापमा		N AH AA P AH M AH AA 
देखाउनुस्।		DH AH EH KA AH AA UH N AH UH S  
दिनुस्		DH AH IH N AH UH S  
दश्		DH AH S  
तोकिएको		TH AH OH K AH IH EH K AH OH 
तेइस		TH AH EH IH S AH 
ढोकाको		DA AH OH K AH AA K AH OH 
डलरका		D AH L AH R AH K AH AA 
ठाँऊ		TA AH AAN UH 
ट्राभलरस्		T  R AH AA BA AH L AH R AH S  
टोक्योको		T AH OH K  Y AH OH K AH OH 
टब		T AH B AH 
जोड्न		JH AH OH D  N AH 
छाती		CHA AH AA TH AH IH 
चौथो		CH AH AH UH THA AH OH 
चौकी		CH AH AH UH K AH IH 
चेकको		CH AH EH K AH K AH OH 
चुरोटहरू		CH AH UH R AH OH T AH HH AH R AH UH 
चुरोटको		CH AH UH R AH OH T AH K AH OH 
गार्हो		G AH AA R  HH AH OH 
गल्ली		G AH L  L AH IH 
गर्नेछौं।		G AH R  N AH EH CHA AH AH UH M
गर्नसक्नु		G AH R  N AH S AH K  N AH UH 
गराईपाउँछु		G AH R AH AA IH P AH AA UHN CHA AH UH 
खेल्नको		KA AH EH L  N AH K AH OH 
खाएर		KA AH AA EH R AH 
खाँदै		KA AH AAN DH AH AH IH 
कुरामा		K AH UH R AH AA M AH AA 
काट्।		K AH AA T  
ओर्लिनुपर्छ		OH R  L AH IH N AH UH P AH R  CHA AH 
ओनो		OH N AH OH 
ऐना		AH IH N AH AA 
एयरलाइन्स		EH Y AH R AH L AH AA IH N  S AH 
एक्सटेन्सन		EH K  S AH T AH EH N  S AH N AH 
एअर		EH AH R AH 
उम्लेको		UH M  L AH EH K AH OH 
उनीले		UH N AH IH L AH EH 
आरामदायी		AA R AH AA M AH DH AH AA Y AH IH 
आकिको		AA K AH IH K AH OH 
अवतरण		AH W AH TH AH R AH N AH 
अप्रिल		AH P  R AH IH L AH 
अटोम्याटिक		AH T AH OH M  Y AH AA T AH IH K AH 
अङ्ग्रेजी		AH NG  G  R AH EH JH AH IH 
अगाडीको		AH G AH AA D AH IH K AH OH 
।		
हेर्नको		HH AH EH R  N AH K AH OH 
हेरिदिनुहुन्छ		HH AH EH R AH IH DH AH IH N AH UH HH AH UH N  CHA AH 
हुनेछु।		HH AH UH N AH EH CHA AH UH 
हुनुहन्छ		HH AH UH N AH UH HH AH N  CHA AH 
हामीहरुलाई		HH AH AA M AH IH HH AH R AH UH L AH AA IH 
हवाईमेलद्वारा		HH AH W AH AA IH M AH EH L AH DH  W AH AA R AH AA 
सुन्ना		S AH UH N  N AH AA 
सितैमा		S AH IH TH AH AH IH M AH AA 
साटिदिनुहोस्		S AH AA T AH IH DH AH IH N AH UH HH AH OH S  
समावेस		S AH M AH AA W AH EH S AH 
सबेरै		S AH B AH EH R AH AH IH 
सबवेबाट		S AH B AH W AH EH B AH AA T AH 
सपिङ		S AH P AH IH NG AH 
शानदार		S AH AA N AH DH AH AA R AH 
ल्याउ		L  Y AH AA UH 
लाइसेन्स		L AH AA IH S AH EH N  S AH 
रेडियो		R AH EH D AH IH Y AH OH 
रहनुहुन्छ		R AH HH AH N AH UH HH AH UH N  CHA AH 
युवा		Y AH UH W AH AA 
यात्री		Y AH AA TH  R AH IH 
मौका		M AH AH UH K AH AA 
मिल्क		M AH IH L  K AH 
मा।		M AH AA 
मार्न		M AH AA R  N AH 
माथी		M AH AA THA AH IH 
भिन्दै		BA AH IH N  DH AH AH IH 
भरिएको		BA AH R AH IH EH K AH OH 
भरपर्दो		BA AH R AH P AH R  DH AH OH 
बिहिबार		B AH IH HH AH IH B AH AA R AH 
बच्चाहरुको		B AH CH  CH AH AA HH AH R AH UH K AH OH 
बचत		B AH CH AH TH AH 
बग्दैन।		B AH G  DH AH AH IH N AH 
फेर्नु		PA AH EH R  N AH UH 
फलफुल		PA AH L AH PA AH UH L AH 
प्राप्त		P  R AH AA P  TH AH 
प्रवेशद्वार		P  R AH W AH EH S AH DH  W AH AA R AH 
पूनः		P AH UH N AH 
पुग्छौ		P AH UH G  CHA AH AH UH 
पिउनसक्छु		P AH IH UH N AH S AH K  CHA AH UH 
पाई		P AH AA IH 
पल्टनुहोस्।		P AH L  T AH N AH UH HH AH OH S  
नोटहरु		N AH OH T AH HH AH R AH UH 
निस्कने		N AH IH S  K AH N AH EH 
नब्बे		N AH B  B AH EH 
दाँतको		DH AH AAN TH AH K AH OH 
त्यो के जस्तो देखिन्छ		TH  Y AH OH DH AH EH KA AH IH N  CHA AH 
त्यसरी		TH  Y AH S AH R AH IH 
तोरी		TH AH OH R AH IH 
तिरे		TH AH IH R AH EH 
तिमीसँग		TH AH IH M AH IH S AHN G AH 
तिनलाई		TH AH IH N AH L AH AA IH 
डाउनटाउन		D AH AA UH N AH T AH AA UH N AH 
टोनिक		T AH OH N AH IH K AH 
टूइन		T AH UH IH N AH 
जीलाई		JH AH IH L AH AA IH 
जान्छ।		JH AH AA N  CHA AH 
जानेबाटो		JH AH AA N AH EH B AH AA T AH OH 
जानुभयो		JH AH AA N AH UH BA AH Y AH OH 
जन्मदिनको		JH AH N  M AH DH AH IH N AH K AH OH 
चुक्ता		CH AH UH K  TH AH AA 
चाँहि		CH AH AAN HH AH IH 
चढें।		CH AH DA AH EH M
घाम		GA AH AA M AH 
घांटी		GA AH AA MT AH IH 
ग्रीन		G  R AH IH N AH 
गाडि		G AH AA D AH IH 
गर्दिनँ।		G AH R  DH AH IH N AHN 
गर्छौँ।		G AH R  CHA AH AH UHN 
गरेँ।		G AH R AH EHN 
गरिपाउन		G AH R AH IH P AH AA UH N AH 
गराउने		G AH R AH AA UH N AH EH 
गति		G AH TH AH IH 
खेल्छु।		KA AH EH L  CHA AH UH 
खेलकुद		KA AH EH L AH K AH UH DH AH 
खानुस।		KA AH AA N AH UH S AH 
कार्यालयमा		K AH AA R  Y AH AA L AH Y AH M AH AA 
कहिलेकाहीं		K AH HH AH IH L AH EH K AH AA HH AH IH M
करोड		K AH R AH OH D AH 
कम्पनिको		K AH M  P AH N AH IH K AH OH 
कतिन्जेल		K AH TH AH IH N  JH AH EH L AH 
उपहारहरु		UH P AH HH AH AA R AH HH AH R AH UH 
उत्तम		UH TH  TH AH M AH 
इ		IH 
आज बिदा हो।		AA JH AH 
आइसक्रिम		AA IH S AH K  R AH IH M AH 
आ		AA 
अहले		AH HH AH L AH EH 
अचार		AH CH AH AA R AH 
अगाड़ी		AH G AH AA D AH IH 
ह्यामबर्गर		HH  Y AH AA M AH B AH R  G AH R AH 
हुलाकद्वारा		HH AH UH L AH AA K AH DH  W AH AA R AH AA 
हवाइजहाज		HH AH W AH AA IH JH AH HH AH AA JH AH 
हफ्ताको		HH AH PA  TH AH AA K AH OH 
हट।		HH AH T AH 
स्थानिय		S  THA AH AA N AH IH Y AH 
स्टार		S  T AH AA R AH 
सेन्टिमिटर		S AH EH N  T AH IH M AH IH T AH R AH 
सुहाएको		S AH UH HH AH AA EH K AH OH 
सुन्य		S AH UH N  Y AH 
सुन्निएको		S AH UH N  N AH IH EH K AH OH 
सुझाब		S AH UH JHA AH AA B AH 
सुख्खा		S AH UH KA  KA AH AA 
साधन		S AH AA DHA AH N AH 
साट्ठी		S AH AA T  TA AH IH 
सवा		S AH W AH AA 
सन्नुहोस्		S AH N  N AH UH HH AH OH S  
सँगैको		S AHN G AH AH IH K AH OH 
विमानस्थलबाट		W AH IH M AH AA N AH S  THA AH L AH B AH AA T AH 
वयस्क।		W AH Y AH S  K AH 
वयस्कको		W AH Y AH S  K AH K AH OH 
लाग्न		L AH AA G  N AH 
लण्डनमा		L AH N  D AH N AH M AH AA 
लगाउनुहुन्छ		L AH G AH AA UH N AH UH HH AH UH N  CHA AH 
रेलमार्गको		R AH EH L AH M AH AA R  G AH K AH OH 
रहन		R AH HH AH N AH 
रसिद।		R AH S AH IH DH AH 
यहिँ		Y AH HH AH IHN 
मोड्नुहोस्		M AH OH D  N AH UH HH AH OH S  
माग		M AH AA G AH 
भुटेको		BA AH UH T AH EH K AH OH 
भित्रमा		BA AH IH TH  R AH M AH AA 
भित्रको		BA AH IH TH  R AH K AH OH 
भव्यसँग		BA AH W  Y AH S AHN G AH 
भगवान।		BA AH G AH W AH AA N AH 
बोर्डिङ गेट नम्बर कति हो		B AH OH R  D AH IH NG AH K AH TH AH IH 
बैक		B AH AH IH K AH 
बिग्रिएको		B AH IH G  R AH IH EH K AH OH 
बच्चाहरु		B AH CH  CH AH AA HH AH R AH UH 
प्लग		P  L AH G AH 
प्राकृतिक		P  R AH AA K AH R TH AH IH K AH 
प्रशस्त		P  R AH S AH S  TH AH 
पोल्छ।		P AH OH L  CHA AH 
पे		P AH EH 
पुर्याउन		P AH UH R  Y AH AA UH N AH 
पुनजारी		P AH UH N AH JH AH AA R AH IH 
पार्लर		P AH AA R  L AH R AH 
पहिल्यै		P AH HH AH IH L  Y AH AH IH 
पस्न		P AH S  N AH 
परिचयपत्र		P AH R AH IH CH AH Y AH P AH TH  R AH 
पकाउन		P AH K AH AA UH N AH 
निर्देशिका		N AH IH R  DH AH EH S AH IH K AH AA 
देखाई		DH AH EH KA AH AA IH 
दुर्घटनामा		DH AH UH R  GA AH T AH N AH AA M AH AA 
दिएँ।		DH AH IH EHN 
दम		DH AH M AH 
थिएन		THA AH IH EH N AH 
तुरन्तै		TH AH UH R AH N  TH AH AH IH 
तिर्नेछु।		TH AH IH R  N AH EH CHA AH UH 
तालीका		TH AH AA L AH IH K AH AA 
ठेगानामा।		TA AH EH G AH AA N AH AA M AH AA 
झर्न		JHA AH R  N AH 
जून		JH AH UH N AH 
जान्ने		JH AH AA N  N AH EH 
जाच		JH AH AA CH AH 
जाँदैन।		JH AH AAN DH AH AH IH N AH 
जसले		JH AH S AH L AH EH 
जतिको		JH AH TH AH IH K AH OH 
चिटिक्क		CH AH IH T AH IH K  K AH 
चाख्न		CH AH AA KA  N AH 
चलाउनुहोस्।		CH AH L AH AA UH N AH UH HH AH OH S  
चलचित्रको		CH AH L AH CH AH IH TH  R AH K AH OH 
गरिदिनुहुन्थ्यो		G AH R AH IH DH AH IH N AH UH HH AH UH N  THA  Y AH OH 
खाइसकेपछि		KA AH AA IH S AH K AH EH P AH CHA AH IH 
कोठा।		K AH OH TA AH AA 
कार्डलाई		K AH AA R  D AH L AH AA IH 
कम्मरको		K AH M  M AH R AH K AH OH 
ओपरेटर		OH P AH R AH EH T AH R AH 
एस्ट्रे		EH S  T  R AH EH 
एक्स्प्रेस		EH K  S  P  R AH EH S AH 
एकलकोठा		EH K AH L AH K AH OH TA AH AA 
एंटीबायोटिकको		EH MT AH IH B AH AA Y AH OH T AH IH K AH K AH OH 
उल्लेख		UH L  L AH EH KA AH 
इच्छुक		IH CH  CHA AH UH K AH 
आइदिनुहुन्छ		AA IH DH AH IH N AH UH HH AH UH N  CHA AH 
अर्को।		AH R  K AH OH 
अभ्यास		AH BA  Y AH AA S AH 
अन्तमा		AH N  TH AH M AH AA 
अन		AH N AH 
हौं।		HH AH AH UH M
हामीहरु		HH AH AA M AH IH HH AH R AH UH 
हाईड		HH AH AA IH D AH 
हवाईजहाजमा		HH AH W AH AA IH JH AH HH AH AA JH AH M AH AA 
हलको		HH AH L AH K AH OH 
स्कूलमा		S  K AH UH L AH M AH AA 
सोधेको		S AH OH DHA AH EH K AH OH 
सेन्टका		S AH EH N  T AH K AH AA 
सेकेण्ड		S AH EH K AH EH N  D AH 
सुनिन।		S AH UH N AH IH N AH 
सिकाइदिनुहोस्		S AH IH K AH AA IH DH AH IH N AH UH HH AH OH S  
साथीहरुको		S AH AA THA AH IH HH AH R AH UH K AH OH 
साटेर		S AH AA T AH EH R AH 
सर्विस।		S AH R  W AH IH S AH 
सक्छौँ।		S AH K  CHA AH AH UHN 
व्यवसायको		W  Y AH W AH S AH AA Y AH K AH OH 
विस्तृत		W AH IH S  TH AH R TH AH 
वहाँ		W AH HH AH AAN 
लास		L AH AA S AH 
लण्डनको		L AH N  D AH N AH K AH OH 
रेकर्ड		R AH EH K AH R  D AH 
रात।		R AH AA TH AH 
राउण्ड		R AH AA UH N  D AH 
युनियन		Y AH UH N AH IH Y AH N AH 
यसो		Y AH S AH OH 
यसभित्र		Y AH S AH BA AH IH TH  R AH 
म्याम्।		M  Y AH AA M  
मिनट		M AH IH N AH T AH 
माछाको		M AH AA CHA AH AA K AH OH 
मंगलबार		M AH MG AH L AH B AH AA R AH 
भेट्दा		BA AH EH T  DH AH AA 
भेटेको		BA AH EH T AH EH K AH OH 
भुक्तानि		BA AH UH K  TH AH AA N AH IH 
भुइंमा		BA AH UH IH MM AH AA 
भागको		BA AH AA G AH K AH OH 
भर्नु		BA AH R  N AH UH 
ब्यागको		B  Y AH AA G AH K AH OH 
बोल्नसक्छु		B AH OH L  N AH S AH K  CHA AH UH 
बुकिङग		B AH UH K AH IH NG AH G AH 
बीच		B AH IH CH AH 
बानिदिनुहोला।		B AH AA N AH IH DH AH IH N AH UH HH AH OH L AH AA 
बादल		B AH AA DH AH L AH 
बजेदेखि		B AH JH AH EH DH AH EH KA AH IH 
फ्ल्यास		PA  L  Y AH AA S AH 
फूल		PA AH UH L AH 
फुटेको		PA AH UH T AH EH K AH OH 
फर्ने		PA AH R  N AH EH 
प्रदर्शनी		P  R AH DH AH R  S AH N AH IH 
पोस्टकार्डहरु		P AH OH S  T AH K AH AA R  D AH HH AH R AH UH 
पुग्नसक्छुहोला		P AH UH G  N AH S AH K  CHA AH UH HH AH OH L AH AA 
पुग्छौँ		P AH UH G  CHA AH AH UHN 
पाउछु		P AH AA UH CHA AH UH 
पाइन।		P AH AA IH N AH 
पढाइ		P AH DA AH AA IH 
नहिचकिचाईकन		N AH HH AH IH CH AH K AH IH CH AH AA IH K AH N AH 
धरौटीको		DHA AH R AH AH UH T AH IH K AH OH 
दुख्न		DH AH UH KA  N AH 
दिन्छ		DH AH IH N  CHA AH 
दयालुपनको		DH AH Y AH AA L AH UH P AH N AH K AH OH 
त्यतो		TH  Y AH TH AH OH 
तेश्रो		TH AH EH S  R AH OH 
तीनमा		TH AH IH N AH M AH AA 
डाईभिंग		D AH AA IH BA AH IH MG AH 
डाइभ		D AH AA IH BA AH 
डलरसँग		D AH L AH R AH S AHN G AH 
टु		T AH UH 
टिकेटहरु।		T AH IH K AH EH T AH HH AH R AH UH 
झर्ने		JHA AH R  N AH EH 
जिम्मा		JH AH IH M  M AH AA 
छालाले		CHA AH AA L AH AA L AH EH 
छान्न		CHA AH AA N  N AH 
छातीमा		CHA AH AA TH AH IH M AH AA 
चेकबाट		CH AH EH K AH B AH AA T AH 
ग्राण्ड		G  R AH AA N  D AH 
गिलासको		G AH IH L AH AA S AH K AH OH 
गर्नुपर्दैन।		G AH R  N AH UH P AH R  DH AH AH IH N AH 
गराउनुहोस्।		G AH R AH AA UH N AH UH HH AH OH S  
गदिनुहोस्।		G AH DH AH IH N AH UH HH AH OH S  
खोकीको		KA AH OH K AH IH K AH OH 
खुद्राहरु		KA AH UH DH  R AH AA HH AH R AH UH 
क्रुज		K  R AH UH JH AH 
क्यान्सिल		K  Y AH AA N  S AH IH L AH 
के भइराखेको छ मलाई		K AH EH M AH L AH AA IH 
कम्तीमा		K AH M  TH AH IH M AH AA 
क		K AH 
ओसार्ने		OH S AH AA R  N AH EH 
एसि		EH S AH IH 
एकदिने		EH K AH DH AH IH N AH EH 
ऋतु		R IH TH AH UH 
उहा		UH HH AH AA 
उनीहरुलाई		UH N AH IH HH AH R AH UH L AH AA IH 
आएका		AA EH K AH AA 
आउँदा		AA UHN DH AH AA 
अलग		AH L AH G AH 
अती		AH TH AH IH 
हेर्नुहोस		HH AH EH R  N AH UH HH AH OH S AH 
हेर्नुहुन्छ		HH AH EH R  N AH UH HH AH UH N  CHA AH 
हुन्न।		HH AH UH N  N AH 
हुन्छन्।		HH AH UH N  CHA AH N  
हुन्छन्		HH AH UH N  CHA AH N  
हुनुहुन्न		HH AH UH N AH UH HH AH UH N  N AH 
हामीहरुको		HH AH AA M AH IH HH AH R AH UH K AH OH 
स्थापना		S  THA AH AA P AH N AH AA 
स्टोरमा		S  T AH OH R AH M AH AA 
सुरू		S AH UH R AH UH 
सुन्तला		S AH UH N  TH AH L AH AA 
सीटमा		S AH IH T AH M AH AA 
सिटहरू		S AH IH T AH HH AH R AH UH 
सानोमा		S AH AA N AH OH M AH AA 
साकिन्छ		S AH AA K AH IH N  CHA AH 
सहभागी		S AH HH AH BA AH AA G AH IH 
ससेज		S AH S AH EH JH AH 
सम्बन्धी		S AH M  B AH N  DHA AH IH 
सम्झौता		S AH M  JHA AH AH UH TH AH AA 
सकेसम्म		S AH K AH EH S AH M  M AH 
सकेजति		S AH K AH EH JH AH TH AH IH 
सकियो		S AH K AH IH Y AH OH 
संकेत		S AH MK AH EH TH AH 
शुन्ना		S AH UH N  N AH AA 
शान्तकोठा		S AH AA N  TH AH K AH OH TA AH AA 
विवाह		W AH IH W AH AA HH AH 
विद्यार्थी		W AH IH DH  Y AH AA R  THA AH IH 
लिए		L AH IH EH 
लायक		L AH AA Y AH K AH 
लामोको		L AH AA M AH OH K AH OH 
लगाईदिनुहोस्।		L AH G AH AA IH DH AH IH N AH UH HH AH OH S  
लगाई		L AH G AH AA IH 
लगाइहेर्न		L AH G AH AA IH HH AH EH R  N AH 
र।		R AH 
रेस्टुरेन्टहरु		R AH EH S  T AH UH R AH EH N  T AH HH AH R AH UH 
रहने		R AH HH AH N AH EH 
रद्ध		R AH DH  DHA AH 
रक्सि		R AH K  S AH IH 
मोडिनुहोस्		M AH OH D AH IH N AH UH HH AH OH S  
मेन्यु		M AH EH N  Y AH UH 
मेक्सिकन		M AH EH K  S AH IH K AH N AH 
मुटुको		M AH UH T AH UH K AH OH 
मासुको		M AH AA S AH UH K AH OH 
मायामी		M AH AA Y AH AA M AH IH 
माफ़		M AH AA PA AH 
मसँगै		M AH S AHN G AH AH IH 
मज्जा		M AH JH  JH AH AA 
भैहाल्छ		BA AH AH IH HH AH AA L  CHA AH 
भेट्टाएको		BA AH EH T  T AH AA EH K AH OH 
भेट्छु।		BA AH EH T  CHA AH UH 
भेटौं		BA AH EH T AH AH UH M
भव्य		BA AH W  Y AH 
भर्नुहोला।		BA AH R  N AH UH HH AH OH L AH AA 
भन्सारमा		BA AH N  S AH AA R AH M AH AA 
ब्याट्रि		B  Y AH AA T  R AH IH 
बोके		B AH OH K AH EH 
बेच्न		B AH EH CH  N AH 
बिहानै		B AH IH HH AH AA N AH AH IH 
बहिनी		B AH HH AH IH N AH IH 
बस्नुभएको		B AH S  N AH UH BA AH EH K AH OH 
बस्नलाई		B AH S  N AH L AH AA IH 
बस्छौ		B AH S  CHA AH AH UH 
बजेबाट		B AH JH AH EH B AH AA T AH 
फ्रिज		PA  R AH IH JH AH 
फोटोहरु		PA AH OH T AH OH HH AH R AH UH 
फाल्नुहोस्।		PA AH AA L  N AH UH HH AH OH S  
फर्स्ट		PA AH R  S  T AH 
फर्कन्छु।		PA AH R  K AH N  CHA AH UH 
परीक्षण		P AH R AH IH K  S AH N AH 
परिवारको		P AH R AH IH W AH AA R AH K AH OH 
पटक।		P AH T AH K AH 
न्युयोर्क		N  Y AH UH Y AH OH R  K AH 
नोटमा		N AH OH T AH M AH AA 
निस्कियो।		N AH IH S  K AH IH Y AH OH 
निस्किएँ।		N AH IH S  K AH IH EHN 
निराश		N AH IH R AH AA S AH 
निःशुल्क		N AH IH S AH UH L  K AH 
नाममा		N AH AA M AH M AH AA 
नकात।		N AH K AH AA TH AH 
धारा		DHA AH AA R AH AA 
दुखेर		DH AH UH KA AH EH R AH 
दुखी		DH AH UH KA AH IH 
दुई।		DH AH UH IH 
दिसा		DH AH IH S AH AA 
दिमागमा		DH AH IH M AH AA G AH M AH AA 
दायाँतिर		DH AH AA Y AH AAN TH AH IH R AH 
थाल		THA AH AA L AH 
त्यसतै		TH  Y AH S AH TH AH AH IH 
तीनजना		TH AH IH N AH JH AH N AH AA 
तिरको		TH AH IH R AH K AH OH 
तिनीहरुको		TH AH IH N AH IH HH AH R AH UH K AH OH 
तपाँइलाई		TH AH P AH AAN IH L AH AA IH 
ठुला		TA AH UH L AH AA 
ट्वाइलेट		T  W AH AA IH L AH EH T AH 
ट्रे		T  R AH EH 
ट्राभलर		T  R AH AA BA AH L AH R AH 
टेवल		T AH EH W AH L AH 
टुइन		T AH UH IH N AH 
जेन		JH AH EH N AH 
जीवन		JH AH IH W AH N AH 
जान्न		JH AH AA N  N AH 
जान्छु		JH AH AA N  CHA AH UH 
जानेछु।		JH AH AA N AH EH CHA AH UH 
छाप		CHA AH AA P AH 
चुरोटहरु		CH AH UH R AH OH T AH HH AH R AH UH 
घन्टा		GA AH N  T AH AA 
गोरुको		G AH OH R AH UH K AH OH 
गुमाएँ।		G AH UH M AH AA EHN 
गर्भवती		G AH R  BA AH W AH TH AH IH 
गन्तब्य		G AH N  TH AH B  Y AH 
खाम		KA AH AA M AH 
खाउँ		KA AH AA UHN 
कोसेलीहरु		K AH OH S AH EH L AH IH HH AH R AH UH 
कोक।		K AH OH K AH 
किन्नुपर्छ		K AH IH N  N AH UH P AH R  CHA AH 
कागजमा		K AH AA G AH JH AH M AH AA 
का		K AH AA 
कम्पनि		K AH M  P AH N AH IH 
कन्सर्टमा		K AH N  S AH R  T AH M AH AA 
एकदिनमा		EH K AH DH AH IH N AH M AH AA 
उठाईदिनुहोला।		UH TA AH AA IH DH AH IH N AH UH HH AH OH L AH AA 
आयो		AA Y AH OH 
आउनुभयो।		AA UH N AH UH BA AH Y AH OH 
आइपुग्छु।		AA IH P AH UH G  CHA AH UH 
अन्तर		AH N  TH AH R AH 
होटेलसम्म।		HH AH OH T AH EH L AH S AH M  M AH 
हेर्छु		HH AH EH R  CHA AH UH 
हेरे		HH AH EH R AH EH 
हेरि		HH AH EH R AH IH 
हुनै		HH AH UH N AH AH IH 
हुनुपर्छ		HH AH UH N AH UH P AH R  CHA AH 
हटाउन		HH AH T AH AA UH N AH 
स्वास्थ्यको		S  W AH AA S  THA  Y AH K AH OH 
स्ट्रिट		S  T  R AH IH T AH 
स्कुबा		S  K AH UH B AH AA 
सोध्नुहोस्।		S AH OH DHA  N AH UH HH AH OH S  
सोध्नु		S AH OH DHA  N AH UH 
सुबिधा।		S AH UH B AH IH DHA AH AA 
सुनिएन।		S AH UH N AH IH EH N AH 
सुट्केस		S AH UH T  K AH EH S AH 
सुझाउ		S AH UH JHA AH AA UH 
सुचना		S AH UH CH AH N AH AA 
सिक्न		S AH IH K  N AH 
सिक्दै		S AH IH K  DH AH AH IH 
सरल		S AH R AH L AH 
सरकारी		S AH R AH K AH AA R AH IH 
समाचारपत्र		S AH M AH AA CH AH AA R AH P AH TH  R AH 
सबैकुरा		S AH B AH AH IH K AH UH R AH AA 
सक्छुहोला		S AH K  CHA AH UH HH AH OH L AH AA 
संग्रालय		S AH MG  R AH AA L AH Y AH 
शैलीको		S AH AH IH L AH IH K AH OH 
शेराटन		S AH EH R AH AA T AH N AH 
वैदेशिक		W AH AH IH DH AH EH S AH IH K AH 
विषेश		W AH IH S AH EH S AH 
विशेषता		W AH IH S AH EH S AH TH AH AA 
विमानस्थलसम्म		W AH IH M AH AA N AH S  THA AH L AH S AH M  M AH 
वाई		W AH AA IH 
ल्याएको		L  Y AH AA EH K AH OH 
लुगाहरू		L AH UH G AH AA HH AH R AH UH 
लिनुहोला		L AH IH N AH UH HH AH OH L AH AA 
लाग्।		L AH AA G  
रेलमार्ग		R AH EH L AH M AH AA R  G AH 
राखिपाउन		R AH AA KA AH IH P AH AA UH N AH 
रङको		R AH NG AH K AH OH 
म्युजिकल		M  Y AH UH JH AH IH K AH L AH 
मुनि		M AH UH N AH IH 
माल		M AH AA L AH 
माथिको		M AH AA THA AH IH K AH OH 
मस्टर्ड		M AH S  T AH R  D AH 
मसाज		M AH S AH AA JH AH 
मर्न		M AH R  N AH 
भोज		BA AH OH JH AH 
भिन्न		BA AH IH N  N AH 
भरि		BA AH R AH IH 
बोन		B AH OH N AH 
बैठक		B AH AH IH TA AH K AH 
बेलायती		B AH EH L AH AA Y AH TH AH IH 
बेर्नुहोस्।		B AH EH R  N AH UH HH AH OH S  
बिबिरा		B AH IH B AH IH R AH AA 
बाहिरको		B AH AA HH AH IH R AH K AH OH 
बाधा		B AH AA DHA AH AA 
बाकी		B AH AA K AH IH 
बस्टनको		B AH S  T AH N AH K AH OH 
बगिरहेको		B AH G AH IH R AH HH AH EH K AH OH 
फर्किन		PA AH R  K AH IH N AH 
फर्कनु		PA AH R  K AH N AH UH 
प्रदर्सनी		P  R AH DH AH R  S AH N AH IH 
प्रत्यक्ष		P  R AH TH  Y AH K  S AH 
पैंतालिस		P AH AH IH MTH AH AA L AH IH S AH 
पेरिसमा		P AH EH R AH IH S AH M AH AA 
पुछ्ने		P AH UH CHA  N AH EH 
पुग्छु।		P AH UH G  CHA AH UH 
पुगेको		P AH UH G AH EH K AH OH 
पियानो		P AH IH Y AH AA N AH OH 
पाउनुहुनेछ।		P AH AA UH N AH UH HH AH UH N AH EH CHA AH 
पाउनुभयो		P AH AA UH N AH UH BA AH Y AH OH 
पर्खिन		P AH R  KA AH IH N AH 
परिवारलाई		P AH R AH IH W AH AA R AH L AH AA IH 
परिरहेको		P AH R AH IH R AH HH AH EH K AH OH 
पराउनुहुन्छ		P AH R AH AA UH N AH UH HH AH UH N  CHA AH 
पथ		P AH THA AH 
पढ्ने		P AH DA  N AH EH 
पढ्नको		P AH DA  N AH K AH OH 
पठाउनको		P AH TA AH AA UH N AH K AH OH 
पठाइदिनुहुन्छ		P AH TA AH AA IH DH AH IH N AH UH HH AH UH N  CHA AH 
पछाडिबाट		P AH CHA AH AA D AH IH B AH AA T AH 
नारिता		N AH AA R AH IH TH AH AA 
नापिदिनुहुन्छ		N AH AA P AH IH DH AH IH N AH UH HH AH UH N  CHA AH 
नभए		N AH BA AH EH 
नछोउ		N AH CHA AH OH UH 
नगरको		N AH G AH R AH K AH OH 
धोएर		DHA AH OH EH R AH 
धरौटी		DHA AH R AH AH UH T AH IH 
देख्नु		DH AH EH KA  N AH UH 
दूरीको		DH AH UH R AH IH K AH OH 
दुईसय		DH AH UH IH S AH Y AH 
दुइटा		DH AH UH IH T AH AA 
तान्ने		TH AH AA N  N AH EH 
तपाँइ		TH AH P AH AAN IH 
डायल		D AH AA Y AH L AH 
ट्याक्सी।		T  Y AH AA K  S AH IH 
टेनिसकोर्ट		T AH EH N AH IH S AH K AH OH R  T AH 
टुरको		T AH UH R AH K AH OH 
टुईन		T AH UH IH N AH 
टायरमा		T AH AA Y AH R AH M AH AA 
झुम्काहरु		JHA AH UH M  K AH AA HH AH R AH UH 
जि		JH AH IH 
जानुस्।		JH AH AA N AH UH S  
जना।		JH AH N AH AA 
जनवरी		JH AH N AH W AH R AH IH 
छुटै		CHA AH UH T AH AH IH 
चाखलाग्दो		CH AH AA KA AH L AH AA G  DH AH OH 
चाख		CH AH AA KA AH 
ग्रे		G  R AH EH 
गोलीगाँठो		G AH OH L AH IH G AH AAN TA AH OH 
गोडा		G AH OH D AH AA 
गृहकार्य		G AH R HH AH K AH AA R  Y AH 
गहना		G AH HH AH N AH AA 
गतिमा		G AH TH AH IH M AH AA 
गइसक्यो।		G AH IH S AH K  Y AH OH 
खानुभएको		KA AH AA N AH UH BA AH EH K AH OH 
केटाको		K AH EH T AH AA K AH OH 
किनकि		K AH IH N AH K AH IH 
कारबाट		K AH AA R AH B AH AA T AH 
कम्प्युटर		K AH M  P  Y AH UH T AH R AH 
कम्पनिमा		K AH M  P AH N AH IH M AH AA 
कफ		K AH PA AH 
ओर्लन्छु।		OH R  L AH N  CHA AH UH 
उमालेको		UH M AH AA L AH EH K AH OH 
उड्ने		UH D  N AH EH 
उड्न		UH D  N AH 
ईस्त्री		IH S  TH  R AH IH 
आहस्मिक		AA HH AH S  M AH IH K AH 
आउनेजाने		AA UH N AH EH JH AH AA N AH EH 
आईरहेको		AA IH R AH HH AH EH K AH OH 
आइपुग्छ		AA IH P AH UH G  CHA AH 
अवलोकन		AH W AH L AH OH K AH N AH 
अपार्टमेन्ट		AH P AH AA R  T AH M AH EH N  T AH 
अपराह्नको		AH P AH R AH AA HH  N AH K AH OH 
अन्डाको		AH N  D AH AA K AH OH 
अनुहार		AH N AH UH HH AH AA R AH 
अक्षर		AH K  S AH R AH 
अंक		AH MK AH 
हेरेको		HH AH EH R AH EH K AH OH 
हवाईजहाजबाट		HH AH W AH AA IH JH AH HH AH AA JH AH B AH AA T AH 
हलिएको		HH AH L AH IH EH K AH OH 
स्वरले		S  W AH R AH L AH EH 
सूचि		S AH UH CH AH IH 
सुनको		S AH UH N AH K AH OH 
सिपालु		S AH IH P AH AA L AH UH 
सार्नुहोस्।		S AH AA R  N AH UH HH AH OH S  
सबैजना		S AH B AH AH IH JH AH N AH AA 
सन्नी		S AH N  N AH IH 
सँगसँगै		S AHN G AH S AHN G AH AH IH 
शैलीमा		S AH AH IH L AH IH M AH AA 
शुल्कमा		S AH UH L  K AH M AH AA 
शिक्षक		S AH IH K  S AH K AH 
शनिवार		S AH N AH IH W AH AA R AH 
शटर		S AH T AH R AH 
विश्राम		W AH IH S  R AH AA M AH 
वाउ		W AH AA UH 
लाम		L AH AA M AH 
रिबन		R AH IH B AH N AH 
राखिने		R AH AA KA AH IH N AH EH 
रहोस्।		R AH HH AH OH S  
यम		Y AH M AH 
यन		Y AH N AH 
मौसमको		M AH AH UH S AH M AH K AH OH 
मै		M AH AH IH 
मेलाई		M AH EH L AH AA IH 
मिनी		M AH IH N AH IH 
माईल		M AH AA IH L AH 
महसूलको		M AH HH AH S AH UH L AH K AH OH 
मन्च		M AH N  CH AH 
भेट्नको		BA AH EH T  N AH K AH OH 
भेट्टाउनुभयो		BA AH EH T  T AH AA UH N AH UH BA AH Y AH OH 
भवनमा		BA AH W AH N AH M AH AA 
भन्छ		BA AH N  CHA AH 
भनिदिन्छु।		BA AH N AH IH DH AH IH N  CHA AH UH 
भएपछि		BA AH EH P AH CHA AH IH 
ब्रिटिस		B  R AH IH T AH IH S AH 
ब्यस्त		B  Y AH S  TH AH 
ब्यक्ति		B  Y AH K  TH AH IH 
बोलाउँछु।		B AH OH L AH AA UHN CHA AH UH 
बुझ्नुहुन्छ		B AH UH JHA  N AH UH HH AH UH N  CHA AH 
बाक्लो		B AH AA K  L AH OH 
बाकि		B AH AA K AH IH 
बस्दा		B AH S  DH AH AA 
बत्तीमा		B AH TH  TH AH IH M AH AA 
बताई		B AH TH AH AA IH 
बजारमा		B AH JH AH AA R AH M AH AA 
फ्री		PA  R AH IH 
फर्किनु		PA AH R  K AH IH N AH UH 
प्ल्याटफर्मबाट		P  L  Y AH AA T AH PA AH R  M AH B AH AA T AH 
प्रतिवेदन		P  R AH TH AH IH W AH EH DH AH N AH 
पूल		P AH UH L AH 
पिन		P AH IH N AH 
पानीसँग		P AH AA N AH IH S AHN G AH 
पाउनुहुन्छ।		P AH AA UH N AH UH HH AH UH N  CHA AH 
पन्ध्रको		P AH N  DHA  R AH K AH OH 
पठाइदिनु		P AH TA AH AA IH DH AH IH N AH UH 
निरको		N AH IH R AH K AH OH 
देख्नुभएको		DH AH EH KA  N AH UH BA AH EH K AH OH 
दुखाईको		DH AH UH KA AH AA IH K AH OH 
दिनुभएको		DH AH IH N AH UH BA AH EH K AH OH 
त्यो कति बेला सुरू हुन्छ		TH  Y AH OH S AH UH R AH UH 
तिरी		TH AH IH R AH IH 
तिनिहरुलाई		TH AH IH N AH IH HH AH R AH UH L AH AA IH 
तारिख।		TH AH AA R AH IH KA AH 
तल्लामा।		TH AH L  L AH AA M AH AA 
तपाइँको		TH AH P AH AA IHN K AH OH 
तन्नाहरु		TH AH N  N AH AA HH AH R AH UH 
डिस्काउन्ट		D AH IH S  K AH AA UH N  T AH 
डिजाइन		D AH IH JH AH AA IH N AH 
ट्याक्सि		T  Y AH AA K  S AH IH 
टुइनकोठा		T AH UH IH N AH K AH OH TA AH AA 
टन्न		T AH N  N AH 
झर्नु		JHA AH R  N AH UH 
झन्डै		JHA AH N  D AH AH IH 
जोन्स		JH AH OH N  S AH 
जीको		JH AH IH K AH OH 
जाँची		JH AH AAN CH AH IH 
छोड्नसक्छु		CHA AH OH D  N AH S AH K  CHA AH UH 
छोडिदिनुहोस्।		CHA AH OH D AH IH DH AH IH N AH UH HH AH OH S  
छुट्टीमा		CHA AH UH T  T AH IH M AH AA 
छुट्टि		CHA AH UH T  T AH IH 
छुटा		CHA AH UH T AH AA 
छिन्		CHA AH IH N  
च्यानेल		CH  Y AH AA N AH EH L AH 
च्यानल		CH  Y AH AA N AH L AH 
चीनी		CH AH IH N AH IH 
चाहिँदैन		CH AH AA HH AH IHN DH AH AH IH N AH 
चाहन्छु्।		CH AH AA HH AH N  CHA AH UH 
चालु		CH AH AA L AH UH 
चाईना		CH AH AA IH N AH AA 
गाडा		G AH AA D AH AA 
गाई		G AH AA IH 
गर्नुहुन्छ।		G AH R  N AH UH HH AH UH N  CHA AH 
गर्दैछौं।		G AH R  DH AH AH IH CHA AH AH UH M
गर्दछु।		G AH R  DH AH CHA AH UH 
गरिन।		G AH R AH IH N AH 
खेर		KA AH EH R AH 
खाएँ।		KA AH AA EHN 
क्रीम		K  R AH IH M AH 
केमिकल्सको		K AH EH M AH IH K AH L  S AH K AH OH 
कुनाको		K AH UH N AH AA K AH OH 
किलो		K AH IH L AH OH 
किमोनो		K AH IH M AH OH N AH OH 
कामको		K AH AA M AH K AH OH 
कापी		K AH AA P AH IH 
करको		K AH R AH K AH OH 
कपडाहरु		K AH P AH D AH AA HH AH R AH UH 
कन्डिसनर		K AH N  D AH IH S AH N AH R AH 
ओर्लने		OH R  L AH N AH EH 
एयरपोर्टमा		EH Y AH R AH P AH OH R  T AH M AH AA 
उपाय		UH P AH AA Y AH 
उत्रन		UH TH  R AH N AH 
उड्छ		UH D  CHA AH 
आकार		AA K AH AA R AH 
अहिलेलाई		AH HH AH IH L AH EH L AH AA IH 
असाध्यै		AH S AH AA DHA  Y AH AH IH 
अपेक्षा		AH P AH EH K  S AH AA 
होलिडे		HH AH OH L AH IH D AH EH 
हील		HH AH IH L AH 
हिमाल		HH AH IH M AH AA L AH 
हिड्न		HH AH IH D  N AH 
हिटर		HH AH IH T AH R AH 
हलकी		HH AH L AH K AH IH 
हन्थ्यो		HH AH N  THA  Y AH OH 
स्पोर्ट		S  P AH OH R  T AH 
स्पेलिंग		S  P AH EH L AH IH MG AH 
स्ट्रीटमा		S  T  R AH IH T AH M AH AA 
स्कार्फ		S  K AH AA R  PA AH 
सून्य		S AH UH N  Y AH 
सूटकेस		S AH UH T AH K AH EH S AH 
सुतेर		S AH UH TH AH EH R AH 
सुक्खा		S AH UH K  KA AH AA 
सीट्		S AH IH T  
सिकागोमा		S AH IH K AH AA G AH OH M AH AA 
सिकागोको		S AH IH K AH AA G AH OH K AH OH 
साथीहरु		S AH AA THA AH IH HH AH R AH UH 
साकाहारी		S AH AA K AH AA HH AH AA R AH IH 
सस्ता		S AH S  TH AH AA 
सम्भावना		S AH M  BA AH AA W AH N AH AA 
सपना		S AH P AH N AH AA 
सतही		S AH TH AH HH AH IH 
सगै		S AH G AH AH IH 
सकिरहेको		S AH K AH IH R AH HH AH EH K AH OH 
श्रेणी		S  R AH EH N AH IH 
शुरुवात		S AH UH R AH UH W AH AA TH AH 
शाकाहारी		S AH AA K AH AA HH AH AA R AH IH 
वेक		W AH EH K AH 
लोसन		L AH OH S AH N AH 
लेराईदिनुहोस्।		L AH EH R AH AA IH DH AH IH N AH UH HH AH OH S  
लेखिदिन्छु।		L AH EH KA AH IH DH AH IH N  CHA AH UH 
लिईदिनुहुन्छ		L AH IH IH DH AH IH N AH UH HH AH UH N  CHA AH 
लाग्दै		L AH AA G  DH AH AH IH 
लन्च		L AH N  CH AH 
लंद्री		L AH MDH  R AH IH 
रोक्छौ		R AH OH K  CHA AH AH UH 
रोकीने		R AH OH K AH IH N AH EH 
रात्रीकालिन		R AH AA TH  R AH IH K AH AA L AH IH N AH 
रातोमा		R AH AA TH AH OH M AH AA 
रसीद		R AH S AH IH DH AH 
रमाएँ।		R AH M AH AA EHN 
यामामोतो		Y AH AA M AH AA M AH OH TH AH OH 
मेशिनमा		M AH EH S AH IH N AH M AH AA 
मूल्यसूची		M AH UH L  Y AH S AH UH CH AH IH 
मिटरमा		M AH IH T AH R AH M AH AA 
माया		M AH AA Y AH AA 
मान्छेलाई		M AH AA N  CHA AH EH L AH AA IH 
माग्न		M AH AA G  N AH 
महँगा		M AH HH AHN G AH AA 
मल		M AH L AH 
भैसकेको		BA AH AH IH S AH K AH EH K AH OH 
भै		BA AH AH IH 
भेट्टायौं		BA AH EH T  T AH AA Y AH AH UH M
भईसक्यो।		BA AH IH S AH K  Y AH OH 
ब्यागेजहरु		B  Y AH AA G AH EH JH AH HH AH R AH UH 
बोस्टनको		B AH OH S  T AH N AH K AH OH 
बुझ्ने		B AH UH JHA  N AH EH 
बीचको		B AH IH CH AH K AH OH 
बल्छी		B AH L  CHA AH IH 
बनाइदिनुहुन्छ		B AH N AH AA IH DH AH IH N AH UH HH AH UH N  CHA AH 
फ्लाइटमा		PA  L AH AA IH T AH M AH AA 
फिका		PA AH IH K AH AA 
फाउन्डेसन		PA AH AA UH N  D AH EH S AH N AH 
प्रोग्राम		P  R AH OH G  R AH AA M AH 
प्रसिध्द		P  R AH S AH IH DHA  DH AH 
प्रसिद्द		P  R AH S AH IH DH  DH AH 
प्रभावित		P  R AH BA AH AA W AH IH TH AH 
प्रतिदिनको		P  R AH TH AH IH DH AH IH N AH K AH OH 
प्याकेज		P  Y AH AA K AH EH JH AH 
पोल्यो।		P AH OH L  Y AH OH 
पो		P AH OH 
पैसालाई		P AH AH IH S AH AA L AH AA IH 
पेरिसको		P AH EH R AH IH S AH K AH OH 
पुस्तकालय		P AH UH S  TH AH K AH AA L AH Y AH 
पुनःजारी		P AH UH N AH JH AH AA R AH IH 
पुग्नको		P AH UH G  N AH K AH OH 
पुगेन		P AH UH G AH EH N AH 
पिकासोको		P AH IH K AH AA S AH OH K AH OH 
पार्किङग		P AH AA R  K AH IH NG AH G AH 
पाठ्यक्रम		P AH AA TA  Y AH K  R AH M AH 
पाचँ		P AH AA CH AHN 
पाउडर		P AH AA UH D AH R AH 
पाइएला		P AH AA IH EH L AH AA 
पर्खिनुहोस्		P AH R  KA AH IH N AH UH HH AH OH S  
पत्रको		P AH TH  R AH K AH OH 
पट		P AH T AH 
पचपन्न		P AH CH AH P AH N  N AH 
निशाना।		N AH IH S AH AA N AH AA 
निर्धारित		N AH IH R  DHA AH AA R AH IH TH AH 
निकास		N AH IH K AH AA S AH 
नाचघर		N AH AA CH AH GA AH R AH 
नगर्नु		N AH G AH R  N AH UH 
नगदले		N AH G AH DH AH L AH EH 
धोका		DHA AH OH K AH AA 
देखिन।		DH AH EH KA AH IH N AH 
दुईमा		DH AH UH IH M AH AA 
दिन्छ।		DH AH IH N  CHA AH 
दिउसो		DH AH IH UH S AH OH 
थिइन्।		THA AH IH IH N  
थाउजेन्ड		THA AH AA UH JH AH EH N  D AH 
त्यहीं		TH  Y AH HH AH IH M
तिम्रोलागि		TH AH IH M  R AH OH L AH AA G AH IH 
तिमिले		TH AH IH M AH IH L AH EH 
तर।		TH AH R AH 
तर्फी।		TH AH R  PA AH IH 
तपाईं लाई पैसा तिर्न कस्तो लाग्छ		TH AH P AH AA IH MTH AH IH R  N AH 
ड्राइ		D  R AH AA IH 
डेस्क।		D AH EH S  K AH 
डीजर्ट		D AH IH JH AH R  T AH 
डिएगो		D AH IH EH G AH OH 
डाक्टरको		D AH AA K  T AH R AH K AH OH 
ठ्याक्क		TA  Y AH AA K  K AH 
ठाउँमा।		TA AH AA UHN M AH AA 
टेबलको		T AH EH B AH L AH K AH OH 
टिकेट।		T AH IH K AH EH T AH 
टापु		T AH AA P AH UH 
टाइम्स		T AH AA IH M  S AH 
जोड्ने		JH AH OH D  N AH EH 
जोडिदिनुहोस्।		JH AH OH D AH IH DH AH IH N AH UH HH AH OH S  
जोडिएको		JH AH OH D AH IH EH K AH OH 
जुत्ताहरू		JH AH UH TH  TH AH AA HH AH R AH UH 
जागिर		JH AH AA G AH IH R AH 
जाँचिदिनुहुन्छ		JH AH AAN CH AH IH DH AH IH N AH UH HH AH UH N  CHA AH 
छापिएको		CHA AH AA P AH IH EH K AH OH 
छत्तीस		CHA AH TH  TH AH IH S AH 
चेरी		CH AH EH R AH IH 
चाहियो		CH AH AA HH AH IH Y AH OH 
चाडो		CH AH AA D AH OH 
चाइनिज		CH AH AA IH N AH IH JH AH 
चाँदी		CH AH AAN DH AH IH 
चश्मा		CH AH S  M AH AA 
चल्न		CH AH L  N AH 
चम्किलो		CH AH M  K AH IH L AH OH 
चढ्नु		CH AH DA  N AH UH 
ग्लास		G  L AH AA S AH 
ग्यासको		G  Y AH AA S AH K AH OH 
गाडीबाट		G AH AA D AH IH B AH AA T AH 
गर्यौं।		G AH R  Y AH AH UH M
गरु		G AH R AH UH 
गराउछौं।		G AH R AH AA UH CHA AH AH UH M
खोजिदिनुहोला।		KA AH OH JH AH IH DH AH IH N AH UH HH AH OH L AH AA 
खेल्दैछन्		KA AH EH L  DH AH AH IH CHA AH N  
खिच्नुहोस्।		KA AH IH CH  N AH UH HH AH OH S  
क्लासमा		K  L AH AA S AH M AH AA 
क्लाइम		K  L AH AA IH M AH 
क्यारेट		K  Y AH AA R AH EH T AH 
कोठालाई		K AH OH TA AH AA L AH AA IH 
केहीपनि		K AH EH HH AH IH P AH N AH IH 
किन्दा		K AH IH N  DH AH AA 
कालोमा		K AH AA L AH OH M AH AA 
काटिदिनुहोस्।		K AH AA T AH IH DH AH IH N AH UH HH AH OH S  
कागजपत्र		K AH AA G AH JH AH P AH TH  R AH 
कहिलेकाहिं		K AH HH AH IH L AH EH K AH AA HH AH IH M
कसै		K AH S AH AH IH 
कष्ट		K AH S  T AH 
कफीको		K AH PA AH IH K AH OH 
कपया		K AH P AH Y AH AA 
औंला		AH UN ML AH AA 
एच		EH CH AH 
एकलै		EH K AH L AH AH IH 
एउटा।		EH UH T AH AA 
ऊन		UH N AH 
उपयोग		UH P AH Y AH OH G AH 
उधारो		UH DHA AH AA R AH OH 
इतिहास		IH TH AH IH HH AH AA S AH 
इच्छा		IH CH  CHA AH AA 
आठको		AA TA AH K AH OH 
आउनुपर्छ		AA UH N AH UH P AH R  CHA AH 
आउछ।		AA UH CHA AH 
अवस्थामा		AH W AH S  THA AH AA M AH AA 
अमिलो		AH M AH IH L AH OH 
अन्तिममा		AH N  TH AH IH M AH M AH AA 
अन्तशुल्क		AH N  TH AH S AH UH L  K AH 
होशियार		HH AH OH S AH IH Y AH AA R AH 
हेरी		HH AH EH R AH IH 
हुनेगरी		HH AH UH N AH EH G AH R AH IH 
हुँदैन		HH AH UHN DH AH AH IH N AH 
हाल्न		HH AH AA L  N AH 
हालें		HH AH AA L AH EH M
हातेझोला		HH AH AA TH AH EH JHA AH OH L AH AA 
हलमा		HH AH L AH M AH AA 
हलका		HH AH L AH K AH AA 
हराएँ		HH AH R AH AA EHN 
हराउनु		HH AH R AH AA UH N AH UH 
हटाईदिनुहुन्छ		HH AH T AH AA IH DH AH IH N AH UH HH AH UH N  CHA AH 
स्विच		S  W AH IH CH AH 
सुलभ		S AH UH L AH BA AH 
सुरुमा		S AH UH R AH UH M AH AA 
सुटर		S AH UH T AH R AH 
सिसा		S AH IH S AH AA 
सार्ने		S AH AA R  N AH EH 
सामानमा		S AH AA M AH AA N AH M AH AA 
साप्ताहिक		S AH AA P  TH AH AA HH AH IH K AH 
सातमा		S AH AA TH AH M AH AA 
साटो		S AH AA T AH OH 
साइटसियिंग		S AH AA IH T AH S AH IH Y AH IH MG AH 
सहि		S AH HH AH IH 
सर्स्युं		S AH R  S  Y AH UH M
सर्कस		S AH R  K AH S AH 
सरासर		S AH R AH AA S AH R AH 
समाप्त		S AH M AH AA P  TH AH 
सञ्चो		S AH N  CH AH OH 
सक्दिन		S AH K  DH AH IH N AH 
सकाउनुभयो		S AH K AH AA UH N AH UH BA AH Y AH OH 
सकाउनु		S AH K AH AA UH N AH UH 
शोको		S AH OH K AH OH 
शास्त्रीय		S AH AA S  TH  R AH IH Y AH 
विषयमा		W AH IH S AH Y AH M AH AA 
विदेशमा		W AH IH DH AH EH S AH M AH AA 
विक्री		W AH IH K  R AH IH 
वाह।		W AH AA HH AH 
वाशिंगटन		W AH AA S AH IH MG AH T AH N AH 
वयस्कहरुको		W AH Y AH S  K AH HH AH R AH UH K AH OH 
ल्याइदिनुहोस्		L  Y AH AA IH DH AH IH N AH UH HH AH OH S  
लेखेर		L AH EH KA AH EH R AH 
लिबर्टी		L AH IH B AH R  T AH IH 
लिन्छौं।		L AH IH N  CHA AH AH UH M
लिन्छु		L AH IH N  CHA AH UH 
लिनुभयो		L AH IH N AH UH BA AH Y AH OH 
लाने		L AH AA N AH EH 
लाग।		L AH AA G AH 
लागो		L AH AA G AH OH 
लाउने		L AH AA UH N AH EH 
लाइहेर्न		L AH AA IH HH AH EH R  N AH 
लम्ब्याउन		L AH M  B  Y AH AA UH N AH 
रोकियो।		R AH OH K AH IH Y AH OH 
रेसर्भेसन		R AH EH S AH R  BA AH EH S AH N AH 
रुटको		R AH UH T AH K AH OH 
रील		R AH IH L AH 
राख्नुहोस्		R AH AA KA  N AH UH HH AH OH S  
राख्नुहुन्छ		R AH AA KA  N AH UH HH AH UH N  CHA AH 
रह्यो।		R AH HH  Y AH OH 
रसिदमा		R AH S AH IH DH AH M AH AA 
रक्सीहरु		R AH K  S AH IH HH AH R AH UH 
रंगहरु		R AH MG AH HH AH R AH UH 
योजनाहरु		Y AH OH JH AH N AH AA HH AH R AH UH 
योको		Y AH OH K AH OH 
यो केको लागी हो		Y AH OH HH AH OH 
याम्डा		Y AH AA M  D AH AA 
यसपछि		Y AH S AH P AH CHA AH IH 
म्याप		M  Y AH AA P AH 
मौसममा		M AH AH UH S AH M AH M AH AA 
मोडल		M AH OH D AH L AH 
मीटर		M AH IH T AH R AH 
मिनरल		M AH IH N AH R AH L AH 
महान		M AH HH AH AA N AH 
महसूल		M AH HH AH S AH UH L AH 
महशुस		M AH HH AH S AH UH S AH 
मदतको		M AH DH AH TH AH K AH OH 
भोलिसम्म		BA AH OH L AH IH S AH M  M AH 
भुजिया।		BA AH UH JH AH IH Y AH AA 
भर्यो।		BA AH R  Y AH OH 
भरिदिनु		BA AH R AH IH DH AH IH N AH UH 
भयानक		BA AH Y AH AA N AH K AH 
भन्छु।		BA AH N  CHA AH UH 
भड्किलो		BA AH D  K AH IH L AH OH 
ब्रिटिश		B  R AH IH T AH IH S AH 
ब्यक्तिगत		B  Y AH K  TH AH IH G AH TH AH 
बोल्छु।		B AH OH L  CHA AH UH 
बेग्लै		B AH EH G  L AH AH IH 
बुझे		B AH UH JHA AH EH 
बिस्राम		B AH IH S  R AH AA M AH 
बिभिन्न		B AH IH BA AH IH N  N AH 
बिचको		B AH IH CH AH K AH OH 
बाल्ने		B AH AA L  N AH EH 
बारको		B AH AA R AH K AH OH 
बस्दैछौ		B AH S  DH AH AH IH CHA AH AH UH 
फोहरा		PA AH OH HH AH R AH AA 
प्रस्ताव		P  R AH S  TH AH AA W AH 
प्रबेश		P  R AH B AH EH S AH 
प्रत्येकको		P  R AH TH  Y AH EH K AH K AH OH 
पैंतालीस		P AH AH IH MTH AH AA L AH IH S AH 
पार्टीको		P AH AA R  T AH IH K AH OH 
पारेको		P AH AA R AH EH K AH OH 
पाएकोमा		P AH AA EH K AH OH M AH AA 
पाइँदैन।		P AH AA IHN DH AH AH IH N AH 
पहिरन		P AH HH AH IH R AH N AH 
पहिचान		P AH HH AH IH CH AH AA N AH 
पर्खिरहेको		P AH R  KA AH IH R AH HH AH EH K AH OH 
परम्परागत		P AH R AH M  P AH R AH AA G AH TH AH 
पन्ध्र।		P AH N  DHA  R AH 
पठाउँछु।		P AH TA AH AA UHN CHA AH UH 
न्यूयोर्कमा		N  Y AH UH Y AH OH R  K AH M AH AA 
निन्द्रा		N AH IH N  DH  R AH AA 
नास्त		N AH AA S  TH AH 
नहुनु		N AH HH AH UH N AH UH 
नमुना		N AH M AH UH N AH AA 
नखाने।		N AH KA AH AA N AH EH 
धारणा		DHA AH AA R AH N AH AA 
दृश्यावलोकनको		DH AH R S  Y AH AA W AH L AH OH K AH N AH K AH OH 
दुःख		DH AH UH KA AH 
दिशा		DH AH IH S AH AA 
दाँतमा		DH AH AAN TH AH M AH AA 
दशमा		DH AH S AH M AH AA 
थियौं।		THA AH IH Y AH AH UH M
थिइन।		THA AH IH IH N AH 
थर		THA AH R AH 
त्यसले		TH  Y AH S AH L AH EH 
तेईस		TH AH EH IH S AH 
ताला		TH AH AA L AH AA 
तारिकमा		TH AH AA R AH IH K AH M AH AA 
तस्विर		TH AH S  W AH IH R AH 
तरीका		TH AH R AH IH K AH AA 
ड्राइभरलाइसेन्स		D  R AH AA IH BA AH R AH L AH AA IH S AH EH N  S AH 
डाउन		D AH AA UH N AH 
ट्रन्कमा		T  R AH N  K AH M AH AA 
ट्रंक		T  R AH MK AH 
टेबल।		T AH EH B AH L AH 
टुरमा		T AH UH R AH M AH AA 
टिप		T AH IH P AH 
झोलाहरू		JHA AH OH L AH AA HH AH R AH UH 
ज्याक		JH  Y AH AA K AH 
जाज		JH AH AA JH AH 
छालामा		CHA AH AA L AH AA M AH AA 
छान्नसक्छु		CHA AH AA N  N AH S AH K  CHA AH UH 
चिजबर्गर		CH AH IH JH AH B AH R  G AH R AH 
चिकित्सकले		CH AH IH K AH IH TH  S AH K AH L AH EH 
चाडै		CH AH AA D AH AH IH 
चाइना		CH AH AA IH N AH AA 
चल्दै		CH AH L  DH AH AH IH 
चप्पल		CH AH P  P AH L AH 
घोडा		GA AH OH D AH AA 
ग्राम		G  R AH AA M AH 
गल्फको		G AH L  PA AH K AH OH 
गर।		G AH R AH 
गर्दिन।		G AH R  DH AH IH N AH 
गफ		G AH PA AH 
गजबको		G AH JH AH B AH K AH OH 
खोज्नुभएको		KA AH OH JH  N AH UH BA AH EH K AH OH 
खानुभयो		KA AH AA N AH UH BA AH Y AH OH 
क्योटो		K  Y AH OH T AH OH 
कोइन		K AH OH IH N AH 
कुखुरा		K AH UH KA AH UH R AH AA 
किमुरा		K AH IH M AH UH R AH AA 
किनमेलको		K AH IH N AH M AH EH L AH K AH OH 
किताबहरू		K AH IH TH AH AA B AH HH AH R AH UH 
कम्मरमा		K AH M  M AH R AH M AH AA 
कममा		K AH M AH M AH AA 
कतिखेर		K AH TH AH IH KA AH EH R AH 
कक्षसेवा		K AH K  S AH S AH EH W AH AA 
औषधिको		AH UN S AH DHA AH IH K AH OH 
ऐड		AH IH D AH 
एक्काईस		EH K  K AH AA IH S AH 
एकछिन।		EH K AH CHA AH IH N AH 
ऋतुमा		R IH TH AH UH M AH AA 
उन्नाईस		UH N  N AH AA IH S AH 
उत्सुक		UH TH  S AH UH K AH 
इन्जेक्शन		IH N  JH AH EH K  S AH N AH 
इन्जन		IH N  JH AH N AH 
इटाली		IH T AH AA L AH IH 
आसा		AA S AH AA 
आरामले		AA R AH AA M AH L AH EH 
आयात		AA Y AH AA TH AH 
आफैं		AA PA AH AH IH M
आपत्ति		AA P AH TH  TH AH IH 
आधी		AA DHA AH IH 
आधि		AA DHA AH IH 
आदेश		AA DH AH EH S AH 
आजकल		AA JH AH K AH L AH 
आईपुग्न		AA IH P AH UH G  N AH 
आइदिनुभएकोमा		AA IH DH AH IH N AH UH BA AH EH K AH OH M AH AA 
अस्पातअल		AH S  P AH AA TH AH AH L AH 
अफ्		AH PA  
अन्डा		AH N  D AH AA 
होश		HH AH OH S AH 
होटेलबाट		HH AH OH T AH EH L AH B AH AA T AH 
होटे		HH AH OH T AH EH 
हुलाकबाट		HH AH UH L AH AA K AH B AH AA T AH 
हुन।		HH AH UH N AH 
हुन्छु		HH AH UH N  CHA AH UH 
हिरा		HH AH IH R AH AA 
हाइड		HH AH AA IH D AH 
हवाइसेवा		HH AH W AH AA IH S AH EH W AH AA 
हल्लाखल्ला		HH AH L  L AH AA KA AH L  L AH AA 
स्वाद।		S  W AH AA DH AH 
स्प्रे		S  P  R AH EH 
सोल		S AH OH L AH 
सुरक्षीत		S AH UH R AH K  S AH IH TH AH 
सुत्नुहोस्।		S AH UH TH  N AH UH HH AH OH S  
सुई		S AH UH IH 
सीटको		S AH IH T AH K AH OH 
सिफारीस		S AH IH PA AH AA R AH IH S AH 
सिङ्गल		S AH IH NG  G AH L AH 
सामानहरुको		S AH AA M AH AA N AH HH AH R AH UH K AH OH 
सामन		S AH AA M AH N AH 
साथीहरुसँग		S AH AA THA AH IH HH AH R AH UH S AHN G AH 
साथीसँग		S AH AA THA AH IH S AHN G AH 
साग		S AH AA G AH 
सम्पूर्ण		S AH M  P AH UH R  N AH 
सक्नुहुनेछ।		S AH K  N AH UH HH AH UH N AH EH CHA AH 
संस्करण		S AH MS  K AH R AH N AH 
संग्रहालयमा		S AH MG  R AH HH AH AA L AH Y AH M AH AA 
शून्य।		S AH UH N  Y AH 
शूद्ध		S AH UH DH  DHA AH 
शुक्रवार		S AH UH K  R AH W AH AA R AH 
शरीरको		S AH R AH IH R AH K AH OH 
व्यापारी		W  Y AH AA P AH AA R AH IH 
विश्व		W AH IH S  W AH 
विदेश		W AH IH DH AH EH S AH 
वाइन्।		W AH AA IH N  
वर्ल्ड		W AH R  L  D AH 
लिंदा		L AH IH MDH AH AA 
लकर		L AH K AH R AH 
रेसेर्भेसनको		R AH EH S AH EH R  BA AH EH S AH N AH K AH OH 
रेशम		R AH EH S AH M AH 
रेन्टल		R AH EH N  T AH L AH 
रसिदको		R AH S AH IH DH AH K AH OH 
रंगीन		R AH MG AH IH N AH 
यो घरको बिशेषता के हो		Y AH OH K AH EH 
म्युजियम		M  Y AH UH JH AH IH Y AH M AH 
म्याम्		M  Y AH AA M  
म्याद		M  Y AH AA DH AH 
मुल्यको		M AH UH L  Y AH K AH OH 
मिनेटजति		M AH IH N AH EH T AH JH AH TH AH IH 
मार्फत		M AH AA R  PA AH TH AH 
मन्द		M AH N  DH AH 
मनपरेको		M AH N AH P AH R AH EH K AH OH 
भेटौं।		BA AH EH T AH AH UH M
भित्री		BA AH IH TH  R AH IH 
भित्रि		BA AH IH TH  R AH IH 
भिक्टोरिया		BA AH IH K  T AH OH R AH IH Y AH AA 
भाग्यमानी		BA AH AA G  Y AH M AH AA N AH IH 
भाँडो		BA AH AAN D AH OH 
ब्रेकफास्ट		B  R AH EH K AH PA AH AA S  T AH 
ब्रिफकेस		B  R AH IH PA AH K AH EH S AH 
ब्युटि		B  Y AH UH T AH IH 
ब्यागमा		B  Y AH AA G AH M AH AA 
बोल्नेकोही		B AH OH L  N AH EH K AH OH HH AH IH 
बोलाईदिनुहोस।		B AH OH L AH AA IH DH AH IH N AH UH HH AH OH S AH 
बोक्नुहुन्छ		B AH OH K  N AH UH HH AH UH N  CHA AH 
बिदेश		B AH IH DH AH EH S AH 
बाड्न		B AH AA D  N AH 
बाईस		B AH AA IH S AH 
बहिर		B AH HH AH IH R AH 
बस्		B AH S  
बल्दैन।		B AH L  DH AH AH IH N AH 
बर्बन		B AH R  B AH N AH 
बन्न		B AH N  N AH 
बनावट		B AH N AH AA W AH T AH 
बढ्न		B AH DA  N AH 
बज्न		B AH JH  N AH 
बच्चालाई		B AH CH  CH AH AA L AH AA IH 
फ्लू		PA  L AH UH 
फ्रान्सिस्कोमा		PA  R AH AA N  S AH IH S  K AH OH M AH AA 
फ्रान्सिली		PA  R AH AA N  S AH IH L AH IH 
फेशन		PA AH EH S AH N AH 
प्रार्थी		P  R AH AA R  THA AH IH 
प्रश्नहरु		P  R AH S  N AH HH AH R AH UH 
प्रभाव		P  R AH BA AH AA W AH 
प्रती		P  R AH TH AH IH 
प्रतिव्यक्ति		P  R AH TH AH IH W  Y AH K  TH AH IH 
पौडि		P AH AH UH D AH IH 
पोकाको		P AH OH K AH AA K AH OH 
पेश		P AH EH S AH 
पुराना		P AH UH R AH AA N AH AA 
पुग्नुपर्छ।		P AH UH G  N AH UH P AH R  CHA AH 
पुगिसक्यो।		P AH UH G AH IH S AH K  Y AH OH 
पार्किंग		P AH AA R  K AH IH MG AH 
पारिदिनुहुन्छ		P AH AA R AH IH DH AH IH N AH UH HH AH UH N  CHA AH 
पानी।		P AH AA N AH IH 
पाखुरा		P AH AA KA AH UH R AH AA 
पाऊँ		P AH AA UHN 
पाउ।		P AH AA UH 
पाइन्ट		P AH AA IH N  T AH 
पहिलेनै		P AH HH AH IH L AH EH N AH AH IH 
पर्खेर		P AH R  KA AH EH R AH 
पठाउनु		P AH TA AH AA UH N AH UH 
न्यास्रो		N  Y AH AA S  R AH OH 
नोटलाई		N AH OH T AH L AH AA IH 
निस्किन्छ।		N AH IH S  K AH IH N  CHA AH 
निम्ति		N AH IH M  TH AH IH 
निजि		N AH IH JH AH IH 
नास्तामा		N AH AA S  TH AH AA M AH AA 
नाडी		N AH AA D AH IH 
नाच्नसक्छु		N AH AA CH  N AH S AH K  CHA AH UH 
नहुनुहोस्।		N AH HH AH UH N AH UH HH AH OH S  
नङ्ग		N AH NG  G AH 
नगर्नुहोला।		N AH G AH R  N AH UH HH AH OH L AH AA 
नगरिकन		N AH G AH R AH IH K AH N AH 
नंग		N AH MG AH 
देखि।		DH AH EH KA AH IH 
देखाउनुहोस।		DH AH EH KA AH AA UH N AH UH HH AH OH S AH 
देखना		DH AH EH KA AH N AH AA 
दृश्यावालोकन		DH AH R S  Y AH AA W AH AA L AH OH K AH N AH 
दुरी		DH AH UH R AH IH 
दिएर		DH AH IH EH R AH 
दिएकोले		DH AH IH EH K AH OH L AH EH 
त्यहाँसम्म		TH  Y AH HH AH AAN S AH M  M AH 
त्यत्ति		TH  Y AH TH  TH AH IH 
तीनसय		TH AH IH N AH S AH Y AH 
तीनको		TH AH IH N AH K AH OH 
तिर्नुहोला।		TH AH IH R  N AH UH HH AH OH L AH AA 
तिर्छु		TH AH IH R  CHA AH UH 
तल्ला		TH AH L  L AH AA 
तनका		TH AH N AH K AH AA 
तट		TH AH T AH 
तखतामा		TH AH KA AH TH AH AA M AH AA 
डिनरको		D AH IH N AH R AH K AH OH 
डगी		D AH G AH IH 
ठाउँहरू		TA AH AA UHN HH AH R AH UH 
ट्रीप		T  R AH IH P AH 
ट्राब्लर्स		T  R AH AA B  L AH R  S AH 
टबको		T AH B AH K AH OH 
झण्डै		JHA AH N  D AH AH IH 
जोड्नुहोस्।		JH AH OH D  N AH UH HH AH OH S  
जेएयल		JH AH EH EH Y AH L AH 
जिम्मेवार		JH AH IH M  M AH EH W AH AA R AH 
जाऊँ		JH AH AA UHN 
जन्म		JH AH N  M AH 
छक्क		CHA AH K  K AH 
चोरिको		CH AH OH R AH IH K AH OH 
चिनी।		CH AH IH N AH IH 
चाहिँदैन।		CH AH AA HH AH IHN DH AH AH IH N AH 
चार्ट		CH AH AA R  T AH 
चलिराखेको		CH AH L AH IH R AH AA KA AH EH K AH OH 
चलन		CH AH L AH N AH 
चमेनाघर		CH AH M AH EH N AH AA GA AH R AH 
चढे		CH AH DA AH EH 
घुमाउने		GA AH UH M AH AA UH N AH EH 
घुमफिरको		GA AH UH M AH PA AH IH R AH K AH OH 
गार्डेन		G AH AA R  D AH EH N AH 
गर्यो।		G AH R  Y AH OH 
गर्यो		G AH R  Y AH OH 
गर्नुहोस््		G AH R  N AH UH HH AH OH S  
गर्छन्		G AH R  CHA AH N  
गरिरहेका		G AH R AH IH R AH HH AH EH K AH AA 
गराइदिनुहोला।		G AH R AH AA IH DH AH IH N AH UH HH AH OH L AH AA 
खोजिदिन		KA AH OH JH AH IH DH AH IH N AH 
खुट्टाको		KA AH UH T  T AH AA K AH OH 
खिच्नुहुन्छ		KA AH IH CH  N AH UH HH AH UH N  CHA AH 
खरानी		KA AH R AH AA N AH IH 
क्यासेट		K  Y AH AA S AH EH T AH 
क्यामेरामा		K  Y AH AA M AH EH R AH AA M AH AA 
क्याट्स		K  Y AH AA T  S AH 
कृपय		K AH R P AH Y AH 
किन्नुभयो		K AH IH N  N AH UH BA AH Y AH OH 
किनें		K AH IH N AH EH M
कार्ट		K AH AA R  T AH 
कलाको		K AH L AH AA K AH OH 
कन्सर्टको		K AH N  S AH R  T AH K AH OH 
कथा		K AH THA AH AA 
औसधि		AH UN S AH DHA AH IH 
ओर्केस्ट्रा		OH R  K AH EH S  T  R AH AA 
ओपरेटर।		OH P AH R AH EH T AH R AH 
एस्		EH S  
एरियाकोड		EH R AH IH Y AH AA K AH OH D AH 
एबिसि		EH B AH IH S AH IH 
एक्स्		EH K  S  
एकदिन		EH K AH DH AH IH N AH 
ऊसले		UH S AH L AH EH 
ऊपहार		UH P AH HH AH AA R AH 
ऊनान्सय		UH N AH AA N  S AH Y AH 
उनीहरू		UH N AH IH HH AH R AH UH 
उताको		UH TH AH AA K AH OH 
उडानहरू		UH D AH AA N AH HH AH R AH UH 
उच्चारण		UH CH  CH AH AA R AH N AH 
इयरफोन		IH Y AH R AH PA AH OH N AH 
आस्पिरिन		AA S  P AH IH R AH IH N AH 
आए		AA EH 
आउनुहुन्न		AA UH N AH UH HH AH UH N  N AH 
आउनुभएकोमा		AA UH N AH UH BA AH EH K AH OH M AH AA 
अघिनै		AH GA AH IH N AH AH IH 
ह्वस्की		HH  W AH S  K AH IH 
होचो		HH AH OH CH AH OH 
हेलो।		HH AH EH L AH OH 
हेरौँ		HH AH EH R AH AH UHN 
हेरिदिन		HH AH EH R AH IH DH AH IH N AH 
हुदैन।		HH AH UH DH AH AH IH N AH 
हालिदिनुहुन्थ्यो		HH AH AA L AH IH DH AH IH N AH UH HH AH UH N  THA  Y AH OH 
हालि		HH AH AA L AH IH 
हातेब्याग		HH AH AA TH AH EH B  Y AH AA G AH 
हा		HH AH AA 
हरुको		HH AH R AH UH K AH OH 
हटाउने		HH AH T AH AA UH N AH EH 
स्थानान्तरण		S  THA AH AA N AH AA N  TH AH R AH N AH 
स्टेसनको		S  T AH EH S AH N AH K AH OH 
स्टेशनसम्म		S  T AH EH S AH N AH S AH M  M AH 
स्टिक		S  T AH IH K AH 
सौचालय		S AH AH UH CH AH AA L AH Y AH 
सोध्छु।		S AH OH DHA  CHA AH UH 
सोच्नुहुन्छ		S AH OH CH  N AH UH HH AH UH N  CHA AH 
सेवाबाट		S AH EH W AH AA B AH AA T AH 
सुविधाजनक		S AH UH W AH IH DHA AH AA JH AH N AH K AH 
सुनिएको		S AH UH N AH IH EH K AH OH 
सुकाउने		S AH UH K AH AA UH N AH EH 
सिटि		S AH IH T AH IH 
सिटहरु।		S AH IH T AH HH AH R AH UH 
सिक्दैछु।		S AH IH K  DH AH AH IH CHA AH UH 
सिकाईदिनुहुन्छ		S AH IH K AH AA IH DH AH IH N AH UH HH AH UH N  CHA AH 
सारै		S AH AA R AH AH IH 
सामानका		S AH AA M AH AA N AH K AH AA 
सानो।		S AH AA N AH OH 
साथीले		S AH AA THA AH IH L AH EH 
सहानुभूति		S AH HH AH AA N AH UH BA AH UH TH AH IH 
सस्		S AH S  
सशुल्क		S AH S AH UH L  K AH 
सर्विस्।		S AH R  W AH IH S  
सर्विस		S AH R  W AH IH S AH 
समुह		S AH M AH UH HH AH 
समस्याको		S AH M AH S  Y AH AA K AH OH 
सफल		S AH PA AH L AH 
सन्तुष्ट		S AH N  TH AH UH S  T AH 
सदस्य		S AH DH AH S  Y AH 
सक्यो।		S AH K  Y AH OH 
सके।		S AH K AH EH 
संख्या		S AH MKA  Y AH AA 
श्वास		S  W AH AA S AH 
श्रीमान।		S  R AH IH M AH AA N AH 
शैली		S AH AH IH L AH IH 
शावरको		S AH AA W AH R AH K AH OH 
व्यवसायमा।		W  Y AH W AH S AH AA Y AH M AH AA 
वेटर		W AH EH T AH R AH 
विमानमा		W AH IH M AH AA N AH M AH AA 
वास्तविक		W AH AA S  TH AH W AH IH K AH 
वातावरण		W AH AA TH AH AA W AH R AH N AH 
वातानाबे		W AH AA TH AH AA N AH AA B AH EH 
वाइ		W AH AA IH 
वर्षमा		W AH R  S AH M AH AA 
वर्ग		W AH R  G AH 
लोक		L AH OH K AH 
लेराउँ		L AH EH R AH AA UHN 
लिनैपर्छ		L AH IH N AH AH IH P AH R  CHA AH 
लिनुहोस््।		L AH IH N AH UH HH AH OH S  
लागेर		L AH AA G AH EH R AH 
लाइ		L AH AA IH 
ला		L AH AA 
लगाइदिनुहोला।		L AH G AH AA IH DH AH IH N AH UH HH AH OH L AH AA 
लक्षणहरु		L AH K  S AH N AH HH AH R AH UH 
रेयर		R AH EH Y AH R AH 
रुगा		R AH UH G AH AA 
रिसेप्सन		R AH IH S AH EH P  S AH N AH 
रिसाउँदिन।		R AH IH S AH AA UHN DH AH IH N AH 
रिस		R AH IH S AH 
राज्यमा		R AH AA JH  Y AH M AH AA 
राख्नसक्छु		R AH AA KA  N AH S AH K  CHA AH UH 
रहनुभएको		R AH HH AH N AH UH BA AH EH K AH OH 
रहदानी।		R AH HH AH DH AH AA N AH IH 
रंगशालामा		R AH MG AH S AH AA L AH AA M AH AA 
रंगशाला		R AH MG AH S AH AA L AH AA 
रँगको		R AHN G AH K AH OH 
यिनी		Y AH IH N AH IH 
यन्त्र		Y AH N  TH  R AH 
यताबाट		Y AH TH AH AA B AH AA T AH 
मेलबक्स		M AH EH L AH B AH K  S AH 
मेरोकोठामा		M AH EH R AH OH K AH OH TA AH AA M AH AA 
मूल्यको		M AH UH L  Y AH K AH OH 
मिलाएर		M AH IH L AH AA EH R AH 
मिनेटभित्र		M AH IH N AH EH T AH BA AH IH TH  R AH 
मात्रै।		M AH AA TH  R AH AH IH 
माइलको		M AH AA IH L AH K AH OH 
महिलाहरु		M AH HH AH IH L AH AA HH AH R AH UH 
मध्यमबाट		M AH DHA  Y AH M AH B AH AA T AH 
मगाउनसक्छु		M AH G AH AA UH N AH S AH K  CHA AH UH 
मँगाएको		M AHN G AH AA EH K AH OH 
भोजमा		BA AH OH JH AH M AH AA 
भाँचियो।		BA AH AAN CH AH IH Y AH OH 
भर्नुपर्छ		BA AH R  N AH UH P AH R  CHA AH 
भन्नुभयो।		BA AH N  N AH UH BA AH Y AH OH 
भई		BA AH IH 
ब्रान्डको		B  R AH AA N  D AH K AH OH 
ब्रन्केट		B  R AH N  K AH EH T AH 
बोलाको		B AH OH L AH AA K AH OH 
बुबा		B AH UH B AH AA 
बीमाको		B AH IH M AH AA K AH OH 
बिराएँ।		B AH IH R AH AA EHN 
बिमानमा		B AH IH M AH AA N AH M AH AA 
बिध्यार्थी		B AH IH DHA  Y AH AA R  THA AH IH 
बस्नुहोला।		B AH S  N AH UH HH AH OH L AH AA 
बल्ल		B AH L  L AH 
बर्णन		B AH R  N AH N AH 
बनाइएको		B AH N AH AA IH EH K AH OH 
बजेसम्मको		B AH JH AH EH S AH M  M AH K AH OH 
बजाउँछन्		B AH JH AH AA UHN CHA AH N  
बक्सिस		B AH K  S AH IH S AH 
फ्रान्सेली		PA  R AH AA N  S AH EH L AH IH 
फोहर		PA AH OH HH AH R AH 
फलफूलको		PA AH L AH PA AH UH L AH K AH OH 
फर्केको		PA AH R  K AH EH K AH OH 
प्लाटफर्म		P  L AH AA T AH PA AH R  M AH 
प्रहरीचौकी		P  R AH HH AH R AH IH CH AH AH UH K AH IH 
पुर्याउँछ		P AH UH R  Y AH AA UHN CHA AH 
पार्कसम्म		P AH AA R  K AH S AH M  M AH 
पहाड		P AH HH AH AA D AH 
पसलबाट		P AH S AH L AH B AH AA T AH 
पत्रिकाहरू		P AH TH  R AH IH K AH AA HH AH R AH UH 
पचासी		P AH CH AH AA S AH IH 
न्यूयोर्कको		N  Y AH UH Y AH OH R  K AH K AH OH 
नोटबुक		N AH OH T AH B AH UH K AH 
नीति		N AH IH TH AH IH 
निस्किन		N AH IH S  K AH IH N AH 
नियमित।		N AH IH Y AH M AH IH TH AH 
नदि		N AH DH AH IH 
नंबरको		N AH MB AH R AH K AH OH 
धून		DHA AH UH N AH 
धन्यावाद।		DHA AH N  Y AH AA W AH AA DH AH 
धन्ना		DHA AH N  N AH AA 
द्धारा		DH  DHA AH AA R AH AA 
दोहोर्याएर		DH AH OH HH AH OH R  Y AH AA EH R AH 
देखाएको		DH AH EH KA AH AA EH K AH OH 
देखा		DH AH EH KA AH AA 
दूतावासमा		DH AH UH TH AH AA W AH AA S AH M AH AA 
दुब्लो		DH AH UH B  L AH OH 
दुखाइ		DH AH UH KA AH AA IH 
दुख		DH AH UH KA AH 
दुईको		DH AH UH IH K AH OH 
दिनहरु		DH AH IH N AH HH AH R AH UH 
दिउँ		DH AH IH UHN 
थोक		THA AH OH K AH 
थप्न		THA AH P  N AH 
त्यहाँँ		TH  Y AH HH AH AAN N 
तिनको		TH AH IH N AH K AH OH 
तल्ला।		TH AH L  L AH AA 
ढुवानि		DA AH UH W AH AA N AH IH 
ड्रेसिंग		D  R AH EH S AH IH MG AH 
डिब्बा		D AH IH B  B AH AA 
डाबर		D AH AA B AH R AH 
डाईभ		D AH AA IH BA AH 
डलरले		D AH L AH R AH L AH EH 
डलरलाई		D AH L AH R AH L AH AA IH 
डब्लु		D AH B  L AH UH 
डकैतीको		D AH K AH AH IH TH AH IH K AH OH 
ठोलो।		TA AH OH L AH OH 
ठाउँबाट		TA AH AA UHN B AH AA T AH 
ट्रयाक		T  R AH Y AH AA K AH 
ट्रफिक		T  R AH PA AH IH K AH 
ट्रंकमा		T  R AH MK AH M AH AA 
टाइ		T AH AA IH 
टर्की		T AH R  K AH IH 
झार		JHA AH AA R AH 
जिस्किंदै		JH AH IH S  K AH IH MDH AH AH IH 
जिरो		JH AH IH R AH OH 
जालको		JH AH AA L AH K AH OH 
जारिगरिदिनु		JH AH AA R AH IH G AH R AH IH DH AH IH N AH UH 
जनालाई		JH AH N AH AA L AH AA IH 
छोडिदिने		CHA AH OH D AH IH DH AH IH N AH EH 
छुट्टिमा		CHA AH UH T  T AH IH M AH AA 
छनौट		CHA AH N AH AH UH T AH 
चिम		CH AH IH M AH 
चिन्हको		CH AH IH N  HH AH K AH OH 
चिजहरु		CH AH IH JH AH HH AH R AH UH 
चाहानुहुन्छ		CH AH AA HH AH AA N AH UH HH AH UH N  CHA AH 
चाहनुहुन्थ्यो		CH AH AA HH AH N AH UH HH AH UH N  THA  Y AH OH 
चारमा		CH AH AA R AH M AH AA 
चाँही		CH AH AAN HH AH IH 
चहकिलो		CH AH HH AH K AH IH L AH OH 
चलाईदिनुहुन्छ		CH AH L AH AA IH DH AH IH N AH UH HH AH UH N  CHA AH 
चर्को		CH AH R  K AH OH 
चम्कीलो		CH AH M  K AH IH L AH OH 
घडीको		GA AH D AH IH K AH OH 
ग्राहक		G  R AH AA HH AH K AH 
गुड्ने		G AH UH D  N AH EH 
गिर्जाघर		G AH IH R  JH AH AA GA AH R AH 
गिजा		G AH IH JH AH AA 
गर्मीमा		G AH R  M AH IH M AH AA 
गरेछु।		G AH R AH EH CHA AH UH 
गरिसकेको		G AH R AH IH S AH K AH EH K AH OH 
गराईदिनुहुन्छ		G AH R AH AA IH DH AH IH N AH UH HH AH UH N  CHA AH 
गयो		G AH Y AH OH 
खोलिदिन		KA AH OH L AH IH DH AH IH N AH 
खेल्दै		KA AH EH L  DH AH AH IH 
खिचौं		KA AH IH CH AH AH UH M
खानुहुँदैन।		KA AH AA N AH UH HH AH UHN DH AH AH IH N AH 
खस्यो।		KA AH S  Y AH OH 
खल्तीमा		KA AH L  TH AH IH M AH AA 
क्लिप		K  L AH IH P AH 
क्रिपय		K  R AH IH P AH Y AH 
क्याबिन		K  Y AH AA B AH IH N AH 
केन्द्रमा		K AH EH N  DH  R AH M AH AA 
केन्ट		K AH EH N  T AH 
केन		K AH EH N AH 
केचअप		K AH EH CH AH AH P AH 
कुम		K AH UH M AH 
कुकुर		K AH UH K AH UH R AH 
किराले		K AH IH R AH AA L AH EH 
किनार		K AH IH N AH AA R AH 
कासिएको		K AH AA S AH IH EH K AH OH 
कार्यालयको		K AH AA R  Y AH AA L AH Y AH K AH OH 
कार्यसमय		K AH AA R  Y AH S AH M AH Y AH 
कारले		K AH AA R AH L AH EH 
काटी		K AH AA T AH IH 
कस्टम		K AH S  T AH M AH 
कलाकारहरू		K AH L AH AA K AH AA R AH HH AH R AH UH 
करसहित		K AH R AH S AH HH AH IH TH AH 
कम्प्यूटर		K AH M  P  Y AH UH T AH R AH 
कम्पनीलाई		K AH M  P AH N AH IH L AH AA IH 
कभरेज		K AH BA AH R AH EH JH AH 
कतिघण्टा		K AH TH AH IH GA AH N  T AH AA 
ओर्लनुपर्छ		OH R  L AH N AH UH P AH R  CHA AH 
ओभरनाईट		OH BA AH R AH N AH AA IH T AH 
ओछ्यान		OH CHA  Y AH AA N AH 
एन्जल्स		EH N  JH AH L  S AH 
एक्सप्रेसको		EH K  S AH P  R AH EH S AH K AH OH 
एक्सटेंशन		EH K  S AH T AH EH MS AH N AH 
एकल		EH K AH L AH 
ऊपहारमा		UH P AH HH AH AA R AH M AH AA 
उहाँहरुलाई		UH HH AH AAN HH AH R AH UH L AH AA IH 
उठ्न		UH TA  N AH 
इश्यू		IH S  Y AH UH 
आहिले		AA HH AH IH L AH EH 
आश्चर्यजनक		AA S  CH AH R  Y AH JH AH N AH K AH 
आयौ।		AA Y AH AH UH 
आठमा		AA TA AH M AH AA 
आउनेछ।		AA UH N AH EH CHA AH 
आईज।		AA IH JH AH 
आइसक्रीम		AA IH S AH K  R AH IH M AH 
अस्वस्थता		AH S  W AH S  THA AH TH AH AA 
असली		AH S AH L AH IH 
अवलोकनको		AH W AH L AH OH K AH N AH K AH OH 
अरुनै		AH R AH UH N AH AH IH 
अफिसर		AH PA AH IH S AH R AH 
अप।		AH P AH 
अन्तराष्ट्रीय		AH N  TH AH R AH AA S  T  R AH IH Y AH 
अनौपचारिक		AH N AH AH UH P AH CH AH AA R AH IH K AH 
अनुसन्धान		AH N AH UH S AH N  DHA AH AA N AH 
अध्यन		AH DHA  Y AH N AH 
अग्रिम		AH G  R AH IH M AH 
होनोलुलु		HH AH OH N AH OH L AH UH L AH UH 
होटेल।		HH AH OH T AH EH L AH 
हेरेर		HH AH EH R AH EH R AH 
हेरिदिनुहोला।		HH AH EH R AH IH DH AH IH N AH UH HH AH OH L AH AA 
हुनेथिएँ।		HH AH UH N AH EH THA AH IH EHN 
हुनाले		HH AH UH N AH AA L AH EH 
हुनसक्छु		HH AH UH N AH S AH K  CHA AH UH 
हुदै		HH AH UH DH AH AH IH 
हुँन्छ		HH AH UHN N  CHA AH 
हिँडेर		HH AH IHN D AH EH R AH 
हावाको		HH AH AA W AH AA K AH OH 
हालिदिनुहोस्।		HH AH AA L AH IH DH AH IH N AH UH HH AH OH S  
हालिदिनुहुन्छ		HH AH AA L AH IH DH AH IH N AH UH HH AH UH N  CHA AH 
हामबर्गर		HH AH AA M AH B AH R  G AH R AH 
हड्डी		HH AH D  D AH IH 
हईन।		HH AH IH N AH 
हँ।		HH AHN 
स्वाश्थ		S  W AH AA S  THA AH 
स्वादको		S  W AH AA DH AH K AH OH 
स्वरमा		S  W AH R AH M AH AA 
स्पेसल		S  P AH EH S AH L AH 
स्नातक		S  N AH AA TH AH K AH 
स्टिकर		S  T AH IH K AH R AH 
सोया		S AH OH Y AH AA 
सोधेर		S AH OH DHA AH EH R AH 
सोच्नुहोस्।		S AH OH CH  N AH UH HH AH OH S  
सोचन		S AH OH CH AH N AH 
सेटको		S AH EH T AH K AH OH 
सुरुंगमार्ग		S AH UH R AH UH MG AH M AH AA R  G AH 
सुन्नुहोस्।		S AH UH N  N AH UH HH AH OH S  
सुन्तालाको		S AH UH N  TH AH AA L AH AA K AH OH 
सुनाउनुहोस्।		S AH UH N AH AA UH N AH UH HH AH OH S  
सीटहरु		S AH IH T AH HH AH R AH UH 
सिस्टम		S AH IH S  T AH M AH 
सित		S AH IH TH AH 
सिटहरुको		S AH IH T AH HH AH R AH UH K AH OH 
सावधान।		S AH AA W AH DHA AH AA N AH 
साल्मोन		S AH AA L  M AH OH N AH 
सामुन्द्र		S AH AA M AH UH N  DH  R AH 
साधारणतया		S AH AA DHA AH AA R AH N AH TH AH Y AH AA 
साटी		S AH AA T AH IH 
सर्टिफिकेट		S AH R  T AH IH PA AH IH K AH EH T AH 
सम्बन्ध		S AH M  B AH N  DHA AH 
समाउनसक्छु		S AH M AH AA UH N AH S AH K  CHA AH UH 
सटल		S AH T AH L AH 
सगँ		S AH G AHN 
संगसंगै		S AH MG AH S AH MG AH AH IH 
सँगैकोकोठामा		S AHN G AH AH IH K AH OH K AH OH TA AH AA M AH AA 
शुक्रबारको		S AH UH K  R AH B AH AA R AH K AH OH 
शिकागोमा		S AH IH K AH AA G AH OH M AH AA 
व्यक्तिविशेष		W  Y AH K  TH AH IH W AH IH S AH EH S AH 
वारेन्टी		W AH AA R AH EH N  T AH IH 
वाइन।		W AH AA IH N AH 
वहुमूल्य		W AH HH AH UH M AH UH L  Y AH 
वर्गको		W AH R  G AH K AH OH 
लुटपाट		L AH UH T AH P AH AA T AH 
लिनुस्।		L AH IH N AH UH S  
लाग्नुभएको		L AH AA G  N AH UH BA AH EH K AH OH 
लाग्दैछु।		L AH AA G  DH AH AH IH CHA AH UH 
लडेर		L AH D AH EH R AH 
लगेर		L AH G AH EH R AH 
लगिदिन्छु।		L AH G AH IH DH AH IH N  CHA AH UH 
लगाउँछु।		L AH G AH AA UHN CHA AH UH 
लंदरी		L AH MDH AH R AH IH 
येनबाट		Y AH EH N AH B AH AA T AH 
यूनियन		Y AH UH N AH IH Y AH N AH 
म्यागजिन		M  Y AH AA G AH JH AH IH N AH 
मोल		M AH OH L AH 
मिलेर		M AH IH L AH EH R AH 
मिलाइ		M AH IH L AH AA IH 
महिनावारी		M AH HH AH IH N AH AA W AH AA R AH IH 
मस्टार्ड		M AH S  T AH AA R  D AH 
भोजनालयको		BA AH OH JH AH N AH AA L AH Y AH K AH OH 
भेट्नेछौं।		BA AH EH T  N AH EH CHA AH AH UH M
भेट्टाउनुहुनेछ।		BA AH EH T  T AH AA UH N AH UH HH AH UH N AH EH CHA AH 
भेटें।		BA AH EH T AH EH M
भाग्यो।		BA AH AA G  Y AH OH 
भरिदिनुहुन्थ्यो		BA AH R AH IH DH AH IH N AH UH HH AH UH N  THA  Y AH OH 
ब्राण्डको		B  R AH AA N  D AH K AH OH 
ब्युँझाइदिन		B  Y AH UHN JHA AH AA IH DH AH IH N AH 
बोलाऊछु।		B AH OH L AH AA UH CHA AH UH 
बोलाइदिनुहुन्थ्यो		B AH OH L AH AA IH DH AH IH N AH UH HH AH UH N  THA  Y AH OH 
बोर्डमा		B AH OH R  D AH M AH AA 
बोकेको		B AH OH K AH EH K AH OH 
बेरमै		B AH EH R AH M AH AH IH 
बुवा		B AH UH W AH AA 
बुबालाई		B AH UH B AH AA L AH AA IH 
बुटिक		B AH UH T AH IH K AH 
बुझ्नु		B AH UH JHA  N AH UH 
बुझेन।		B AH UH JHA AH EH N AH 
बीफ		B AH IH PA AH 
बिल्डिंग		B AH IH L  D AH IH MG AH 
बिदाको		B AH IH DH AH AA K AH OH 
बिताउन		B AH IH TH AH AA UH N AH 
बिचार।		B AH IH CH AH AA R AH 
बाहिरी		B AH AA HH AH IH R AH IH 
बस्नको		B AH S  N AH K AH OH 
बसाईमा		B AH S AH AA IH M AH AA 
बनाइदिन		B AH N AH AA IH DH AH IH N AH 
बढ्नुहोस्।		B AH DA  N AH UH HH AH OH S  
फ्लाइटहरु		PA  L AH AA IH T AH HH AH R AH UH 
फित्ता		PA AH IH TH  TH AH AA 
फिट		PA AH IH T AH 
फिक्का		PA AH IH K  K AH AA 
फर्किन्छ।		PA AH R  K AH IH N  CHA AH 
फर्काउने		PA AH R  K AH AA UH N AH EH 
प्लेन		P  L AH EH N AH 
प्रारम्भिक		P  R AH AA R AH M  BA AH IH K AH 
प्रस्थानको		P  R AH S  THA AH AA N AH K AH OH 
प्रदर्शनको		P  R AH DH AH R  S AH N AH K AH OH 
प्रतीक्षा		P  R AH TH AH IH K  S AH AA 
प्रतिघण्टा		P  R AH TH AH IH GA AH N  T AH AA 
प्याड		P  Y AH AA D AH 
पोल्नुस।		P AH OH L  N AH UH S AH 
पॉच		P AH CH AH 
पैसाबाट		P AH AH IH S AH AA B AH AA T AH 
पैतालीस		P AH AH IH TH AH AA L AH IH S AH 
पैंताला		P AH AH IH MTH AH AA L AH AA 
पेसा		P AH EH S AH AA 
पुर्याईदिनुहुन्छ		P AH UH R  Y AH AA IH DH AH IH N AH UH HH AH UH N  CHA AH 
पुग्नेछौं		P AH UH G  N AH EH CHA AH AH UH M
पुगिन्छ।		P AH UH G AH IH N  CHA AH 
पीडाको		P AH IH D AH AA K AH OH 
पिसाब		P AH IH S AH AA B AH 
पिउदा		P AH IH UH DH AH AA 
पाहुना		P AH AA HH AH UH N AH AA 
पासपोर्टको		P AH AA S AH P AH OH R  T AH K AH OH 
पाकने		P AH AA K AH N AH EH 
पहेँलो		P AH HH AH EHN L AH OH 
पर्सी		P AH R  S AH IH 
पर्नेछ।		P AH R  N AH EH CHA AH 
पर्खिनुहोला।		P AH R  KA AH IH N AH UH HH AH OH L AH AA 
पचासको		P AH CH AH AA S AH K AH OH 
नुहाउनेकोठामा		N AH UH HH AH AA UH N AH EH K AH OH TA AH AA M AH AA 
नीलोमा		N AH IH L AH OH M AH AA 
निस्क्यो।		N AH IH S  K  Y AH OH 
निर्गम		N AH IH R  G AH M AH 
नतीजा		N AH TH AH IH JH AH AA 
धुलो		DHA AH UH L AH OH 
धाराको		DHA AH AA R AH AA K AH OH 
धन्यबाद		DHA AH N  Y AH B AH AA DH AH 
द्रुतसेवा		DH  R AH UH TH AH S AH EH W AH AA 
दोहोरो		DH AH OH HH AH OH R AH OH 
देखाइदिनुहोस्		DH AH EH KA AH AA IH DH AH IH N AH UH HH AH OH S  
देउ।		DH AH EH UH 
दुवै		DH AH UH W AH AH IH 
दिनुपर्छ।		DH AH IH N AH UH P AH R  CHA AH 
दिक्क		DH AH IH K  K AH 
तिखो		TH AH IH KA AH OH 
तापमान		TH AH AA P AH M AH AA N AH 
तपाईंकोकोठा		TH AH P AH AA IH MK AH OH K AH OH TA AH AA 
तपाईँसँग		TH AH P AH AA IHN S AHN G AH 
ड्राभीङ		D  R AH AA BA AH IH NG AH 
डिस्कोमा		D AH IH S  K AH OH M AH AA 
डिसेम्बर		D AH IH S AH EH M  B AH R AH 
डाइभिङ		D AH AA IH BA AH IH NG AH 
ठेलाहरु		TA AH EH L AH AA HH AH R AH UH 
ठीक्क		TA AH IH K  K AH 
ठाउँहरुको		TA AH AA UHN HH AH R AH UH K AH OH 
ट्वाईलेट		T  W AH AA IH L AH EH T AH 
ट्रान्सफर।		T  R AH AA N  S AH PA AH R AH 
ट्याक्सीसम्म		T  Y AH AA K  S AH IH S AH M  M AH 
ट्याक्स		T  Y AH AA K  S AH 
टिप्स		T AH IH P  S AH 
जोर्नी		JH AH OH R  N AH IH 
जेट		JH AH EH T AH 
जीले		JH AH IH L AH EH 
जिउको		JH AH IH UH K AH OH 
जापान।		JH AH AA P AH AA N AH 
जापानका		JH AH AA P AH AA N AH K AH AA 
जापनी		JH AH AA P AH N AH IH 
जानुहोस।		JH AH AA N AH UH HH AH OH S AH 
जादै		JH AH AA DH AH AH IH 
जाडोमा		JH AH AA D AH OH M AH AA 
जाउँ		JH AH AA UHN 
जाँदैछ।		JH AH AAN DH AH AH IH CHA AH 
जहाजको		JH AH HH AH AA JH AH K AH OH 
जनसङ्ख्या		JH AH N AH S AH NG  KA  Y AH AA 
चौबिस		CH AH AH UH B AH IH S AH 
चेक ईन समय के हो		CH AH EH K AH K AH EH 
चुहिरहेको		CH AH UH HH AH IH R AH HH AH EH K AH OH 
चियामा		CH AH IH Y AH AA M AH AA 
चिनाउन		CH AH IH N AH AA UH N AH 
चित्त		CH AH IH TH  TH AH 
चालकलाई		CH AH AA L AH K AH L AH AA IH 
चालकको		CH AH AA L AH K AH K AH OH 
चाईनिज		CH AH AA IH N AH IH JH AH 
चलचित्रहरू		CH AH L AH CH AH IH TH  R AH HH AH R AH UH 
चलचित्रहरु		CH AH L AH CH AH IH TH  R AH HH AH R AH UH 
चढेको		CH AH DA AH EH K AH OH 
चक्कू		CH AH K  K AH UH 
घुँडा		GA AH UHN D AH AA 
गोरो		G AH OH R AH OH 
गुणस्तरको		G AH UH N AH S  TH AH R AH K AH OH 
गल्लीमा		G AH L  L AH IH M AH AA 
गर्नुस।		G AH R  N AH UH S AH 
गरेपछि		G AH R AH EH P AH CHA AH IH 
खोसेर		KA AH OH S AH EH R AH 
खोजिदिनुहुन्छ		KA AH OH JH AH IH DH AH IH N AH UH HH AH UH N  CHA AH 
खैरोमा		KA AH AH IH R AH OH M AH AA 
खेलाडी		KA AH EH L AH AA D AH IH 
खुल्छ।		KA AH UH L  CHA AH 
खानालाई		KA AH AA N AH AA L AH AA IH 
खानापछि		KA AH AA N AH AA P AH CHA AH IH 
खको		KA AH K AH OH 
क्लिनिक		K  L AH IH N AH IH K AH 
क्रिस्ट्मस।		K  R AH IH S  T  M AH S AH 
क्योटोमा		K  Y AH OH T AH OH M AH AA 
क्यारेटको		K  Y AH AA R AH EH T AH K AH OH 
क्याफे		K  Y AH AA PA AH EH 
कोसँग		K AH OH S AHN G AH 
केस		K AH EH S AH 
केन्जी		K AH EH N  JH AH IH 
केटीको		K AH EH T AH IH K AH OH 
केटिको		K AH EH T AH IH K AH OH 
केको		K AH EH K AH OH 
कुनैपनि		K AH UH N AH AH IH P AH N AH IH 
कुना		K AH UH N AH AA 
किनेको।		K AH IH N AH EH K AH OH 
किनारामा		K AH IH N AH AA R AH AA M AH AA 
कार्टून		K AH AA R  T AH UH N AH 
कारलाई		K AH AA R AH L AH AA IH 
काट्यो।		K AH AA T  Y AH OH 
काटि		K AH AA T AH IH 
कागजहरु		K AH AA G AH JH AH HH AH R AH UH 
काँधमा		K AH AAN DHA AH M AH AA 
कहिलै		K AH HH AH IH L AH AH IH 
कलामा		K AH L AH AA M AH AA 
कलको		K AH L AH K AH OH 
कम्बिनेसन		K AH M  B AH IH N AH EH S AH N AH 
कतिदिन		K AH TH AH IH DH AH IH N AH 
कक्षामा		K AH K  S AH AA M AH AA 
कंपनीलाई		K AH MP AH N AH IH L AH AA IH 
ओ।		OH 
एजेन्सी		EH JH AH EH N  S AH IH 
एक्सपोजरको		EH K  S AH P AH OH JH AH R AH K AH OH 
उपस्थित		UH P AH S  THA AH IH TH AH 
उठेको		UH TA AH EH K AH OH 
इलाका		IH L AH AA K AH AA 
आवेदन		AA W AH EH DH AH N AH 
आमालाई		AA M AH AA L AH AA IH 
आउनुपर्छ।		AA UH N AH UH P AH R  CHA AH 
आइपुग्छौं		AA IH P AH UH G  CHA AH AH UH M
अस्वस्थ		AH S  W AH S  THA AH 
अस्पतालको		AH S  P AH TH AH AA L AH K AH OH 
अरेन्ज		AH R AH EH N  JH AH 
अरुकेही		AH R AH UH K AH EH HH AH IH 
अमेरीकन		AH M AH EH R AH IH K AH N AH 
अमेरिकाबाट		AH M AH EH R AH IH K AH AA B AH AA T AH 
अपराह्न		AH P AH R AH AA HH  N AH 
अझसम्म		AH JHA AH S AH M  M AH 
फ़्रेन्च		 R AH EH N  CH AH 
हुन्दैन		HH AH UH N  DH AH AH IH N AH 
हुनेछौं।		HH AH UH N AH EH CHA AH AH UH M
हुनसक्छ		HH AH UH N AH S AH K  CHA AH 
हुँन्छ।		HH AH UHN N  CHA AH 
हुँदैछ।		HH AH UHN DH AH AH IH CHA AH 
स्वीटर		S  W AH IH T AH R AH 
स्वीच		S  W AH IH CH AH 
स्लट		S  L AH T AH 
स्याउको		S  Y AH AA UH K AH OH 
स्याउ		S  Y AH AA UH 
स्मारक		S  M AH AA R AH K AH 
स्ट्याण्डमा		S  T  Y AH AA N  D AH M AH AA 
स्कूलको		S  K AH UH L AH K AH OH 
सोमवार		S AH OH M AH W AH AA R AH 
सेन्ट्राल		S AH EH N  T  R AH AA L AH 
सेन्टरमा		S AH EH N  T AH R AH M AH AA 
सेन्टरको		S AH EH N  T AH R AH K AH OH 
सेकेको		S AH EH K AH EH K AH OH 
सुहाउँछ।		S AH UH HH AH AA UHN CHA AH 
सुरुवात		S AH UH R AH UH W AH AA TH AH 
सुन्दर।		S AH UH N  DH AH R AH 
सिलसिलामा		S AH IH L AH S AH IH L AH AA M AH AA 
सिफारीश		S AH IH PA AH AA R AH IH S AH 
सिनेमा		S AH IH N AH EH M AH AA 
सिड्नी		S AH IH D  N AH IH 
सिकारुको		S AH IH K AH AA R AH UH K AH OH 
सिकाउने		S AH IH K AH AA UH N AH EH 
सामानहरु।		S AH AA M AH AA N AH HH AH R AH UH 
साधे		S AH AA DHA AH EH 
साटिदिनुहुन्थ्यो		S AH AA T AH IH DH AH IH N AH UH HH AH UH N  THA  Y AH OH 
साचो		S AH AA CH AH OH 
साईकल		S AH AA IH K AH L AH 
समुद्रको		S AH M AH UH DH  R AH K AH OH 
समात्नु		S AH M AH AA TH  N AH UH 
सत्य		S AH TH  Y AH 
सत्ताईस		S AH TH  TH AH AA IH S AH 
सडकबाट		S AH D AH K AH B AH AA T AH 
सक्दैनौ।		S AH K  DH AH AH IH N AH AH UH 
सकियेन।		S AH K AH IH Y AH EH N AH 
श्रेणीमा		S  R AH EH N AH IH M AH AA 
श्रीमतीको		S  R AH IH M AH TH AH IH K AH OH 
शुरुमा		S AH UH R AH UH M AH AA 
शिरानी		S AH IH R AH AA N AH IH 
शहरकोलागि		S AH HH AH R AH K AH OH L AH AA G AH IH 
शब्दको		S AH B  DH AH K AH OH 
व्यवहार		W  Y AH W AH HH AH AA R AH 
वे		W AH EH 
वीजा		W AH IH JH AH AA 
विभागको		W AH IH BA AH AA G AH K AH OH 
विन्ड		W AH IH N  D AH 
लिमुजीन		L AH IH M AH UH JH AH IH N AH 
लिनुभएको		L AH IH N AH UH BA AH EH K AH OH 
लागिसक्यो।		L AH AA G AH IH S AH K  Y AH OH 
लाउन्ड्री		L AH AA UH N  D  R AH IH 
लाईसेन्स		L AH AA IH S AH EH N  S AH 
लहर		L AH HH AH R AH 
लन्दन		L AH N  DH AH N AH 
लगि		L AH G AH IH 
रोमान्चक		R AH OH M AH AA N  CH AH K AH 
रोममा		R AH OH M AH M AH AA 
रोगको		R AH OH G AH K AH OH 
रेसेर्भेसन		R AH EH S AH EH R  BA AH EH S AH N AH 
रुक्न		R AH UH K  N AH 
राजदुतावासमा		R AH AA JH AH DH AH UH TH AH AA W AH AA S AH M AH AA 
राखे		R AH AA KA AH EH 
रहीरहन्छ		R AH HH AH IH R AH HH AH N  CHA AH 
यात्रीको		Y AH AA TH  R AH IH K AH OH 
मोडेल		M AH OH D AH EH L AH 
मोडमा		M AH OH D AH M AH AA 
मोटो		M AH OH T AH OH 
मुक्ति		M AH UH K  TH AH IH 
मीनेट		M AH IH N AH EH T AH 
मिलाएको		M AH IH L AH AA EH K AH OH 
मिनेरल		M AH IH N AH EH R AH L AH 
मार्गमा		M AH AA R  G AH M AH AA 
मार्गबाट		M AH AA R  G AH B AH AA T AH 
माछामा		M AH AA CHA AH AA M AH AA 
महासागरको		M AH HH AH AA S AH AA G AH R AH K AH OH 
महत्वपुर्ण		M AH HH AH TH  W AH P AH UH R  N AH 
मसला		M AH S AH L AH AA 
मञ्च		M AH N  CH AH 
भेनिला		BA AH EH N AH IH L AH AA 
भेटौँ।		BA AH EH T AH AH UHN 
भूमिगत		BA AH UH M AH IH G AH TH AH 
भी		BA AH IH 
भिन्दा		BA AH IH N  DH AH AA 
भयानकसँग		BA AH Y AH AA N AH K AH S AHN G AH 
भनेको।		BA AH N AH EH K AH OH 
ब्लो		B  L AH OH 
बोस्टनमा		B AH OH S  T AH N AH M AH AA 
बेस्सरी		B AH EH S  S AH R AH IH 
बेलायतमा		B AH EH L AH AA Y AH TH AH M AH AA 
बुरैक		B AH UH R AH AH IH K AH 
बुट्टा		B AH UH T  T AH AA 
बिजुली		B AH IH JH AH UH L AH IH 
बाल्न		B AH AA L  N AH 
बसे		B AH S AH EH 
बसहरू		B AH S AH HH AH R AH UH 
बर्थ		B AH R  THA AH 
बनाइदिनुहोस्		B AH N AH AA IH DH AH IH N AH UH HH AH OH S  
बदल्नुहोस्।		B AH DH AH L  N AH UH HH AH OH S  
बट्टा		B AH T  T AH AA 
फोटोकपि		PA AH OH T AH OH K AH P AH IH 
फुड		PA AH UH D AH 
फिल्टर		PA AH IH L  T AH R AH 
फिफ्थ		PA AH IH PA  THA AH 
फाइदा		PA AH AA IH DH AH AA 
फर्कनुपर्छ।		PA AH R  K AH N AH UH P AH R  CHA AH 
प्लेटफर्मबाट		P  L AH EH T AH PA AH R  M AH B AH AA T AH 
प्लास्टिकको		P  L AH AA S  T AH IH K AH K AH OH 
प्रेम		P  R AH EH M AH 
पौने		P AH AH UH N AH EH 
पेट्रोलपम्प		P AH EH T  R AH OH L AH P AH M  P AH 
पुर्याइदिनुहुन्छ		P AH UH R  Y AH AA IH DH AH IH N AH UH HH AH UH N  CHA AH 
पुर्ण		P AH UH R  N AH 
पुनः		P AH UH N AH 
पार्नुहोस्।		P AH AA R  N AH UH HH AH OH S  
पानीले		P AH AA N AH IH L AH EH 
पानि		P AH AA N AH IH 
पाचौं		P AH AA CH AH AH UH M
पाएँ		P AH AA EHN 
पाउन्डमा		P AH AA UH N  D AH M AH AA 
पाँचौँ		P AH AAN CH AH AH UHN 
पहिलाको		P AH HH AH IH L AH AA K AH OH 
पसलहरू		P AH S AH L AH HH AH R AH UH 
पर्सि		P AH R  S AH IH 
पर्यटकको		P AH R  Y AH T AH K AH K AH OH 
पर्		P AH R  
परिचित		P AH R AH IH CH AH IH TH AH 
पप		P AH P AH 
पन्ध्रमा		P AH N  DHA  R AH M AH AA 
पन्चानब्बे		P AH N  CH AH AA N AH B  B AH EH 
पदार्थको		P AH DH AH AA R  THA AH K AH OH 
पठाइदिनुहोस्		P AH TA AH AA IH DH AH IH N AH UH HH AH OH S  
पछी।		P AH CHA AH IH 
पछाडीको		P AH CHA AH AA D AH IH K AH OH 
पचाउने		P AH CH AH AA UH N AH EH 
नेगेटिभको		N AH EH G AH EH T AH IH BA AH K AH OH 
नुनिलो		N AH UH N AH IH L AH OH 
निवेदन		N AH IH W AH EH DH AH N AH 
निर्धारण		N AH IH R  DHA AH AA R AH N AH 
नियमहरु		N AH IH Y AH M AH HH AH R AH UH 
निद्रा		N AH IH DH  R AH AA 
नाजिक		N AH AA JH AH IH K AH 
नाकामुरा		N AH AA K AH AA M AH UH R AH AA 
नजीकको		N AH JH AH IH K AH K AH OH 
धेरैनै		DHA AH EH R AH AH IH N AH AH IH 
धुँवा		DHA AH UHN W AH AA 
द्वारा		DH  W AH AA R AH AA 
द्रेस्सिंग		DH  R AH EH S  S AH IH MG AH 
दिनसम्म		DH AH IH N AH S AH M  M AH 
दिईन्छ		DH AH IH IH N  CHA AH 
दाया		DH AH AA Y AH AA 
दरबार		DH AH R AH B AH AA R AH 
दमकल		DH AH M AH K AH L AH 
दध		DH AH DHA AH 
थीचे		THA AH IH CH AH EH 
थाल्यो।		THA AH AA L  Y AH OH 
थाकेको		THA AH AA K AH EH K AH OH 
त्यतिबेला		TH  Y AH TH AH IH B AH EH L AH AA 
तिरें।		TH AH IH R AH EH M
तल्लीन		TH AH L  L AH IH N AH 
तर्फबाट।		TH AH R  PA AH B AH AA T AH 
तपाइँलाई		TH AH P AH AA IHN L AH AA IH 
डोभरको		D AH OH BA AH R AH K AH OH 
डोभर		D AH OH BA AH R AH 
डुङ्गा		D AH UH NG  G AH AA 
डिजाइनमा		D AH IH JH AH AA IH N AH M AH AA 
डलरभन्दा		D AH L AH R AH BA AH N  DH AH AA 
ठोक्यो।		TA AH OH K  Y AH OH 
ठाडो		TA AH AA D AH OH 
ट्वाइलेटको		T  W AH AA IH L AH EH T AH K AH OH 
ट्रेनहरू		T  R AH EH N AH HH AH R AH UH 
ट्रेनबाट		T  R AH EH N AH B AH AA T AH 
ट्रन्क		T  R AH N  K AH 
ट्रक		T  R AH K AH 
टोक्योमा		T AH OH K  Y AH OH M AH AA 
टेलिग्रामको		T AH EH L AH IH G  R AH AA M AH K AH OH 
टिकटले		T AH IH K AH T AH L AH EH 
टाउकोमा		T AH AA UH K AH OH M AH AA 
टमाटर		T AH M AH AA T AH R AH 
झोला।		JHA AH OH L AH AA 
जुवा		JH AH UH W AH AA 
जिम		JH AH IH M AH 
जारि		JH AH AA R AH IH 
जानाको		JH AH AA N AH AA K AH OH 
जाँदैछौं।		JH AH AAN DH AH AH IH CHA AH AH UH M
जाँचीदिन		JH AH AAN CH AH IH DH AH IH N AH 
जर्मन		JH AH R  M AH N AH 
जनसंख्या		JH AH N AH S AH MKA  Y AH AA 
छुट्याएर		CHA AH UH T  Y AH AA EH R AH 
छिरेको		CHA AH IH R AH EH K AH OH 
छानेको		CHA AH AA N AH EH K AH OH 
छमा		CHA AH M AH AA 
चौथौं		CH AH AH UH THA AH AH UH M
चोर्यो।		CH AH OH R  Y AH OH 
चोरलाई		CH AH OH R AH L AH AA IH 
चेकइन		CH AH EH K AH IH N AH 
चिलायो।		CH AH IH L AH AA Y AH OH 
चिरा		CH AH IH R AH AA 
चिन्नुहुन्छ		CH AH IH N  N AH UH HH AH UH N  CHA AH 
चिजको		CH AH IH JH AH K AH OH 
चाहिंदैन		CH AH AA HH AH IH MDH AH AH IH N AH 
चाहि		CH AH AA HH AH IH 
चाहँदिन।		CH AH AA HH AHN DH AH IH N AH 
चाबी		CH AH AA B AH IH 
चक्कुले		CH AH K  K AH UH L AH EH 
घाँटीमा		GA AH AAN T AH IH M AH AA 
घडीहरू		GA AH D AH IH HH AH R AH UH 
ग्लफ		G  L AH PA AH 
ग्यालरी		G  Y AH AA L AH R AH IH 
गोली		G AH OH L AH IH 
गाडीहरु		G AH AA D AH IH HH AH R AH UH 
गर्नु।		G AH R  N AH UH 
गर्नुहोस््।		G AH R  N AH UH HH AH OH S  
गर्नुभएकोमा		G AH R  N AH UH BA AH EH K AH OH M AH AA 
गर्छौ		G AH R  CHA AH AH UH 
गरेकै		G AH R AH EH K AH AH IH 
गरुङ्गो		G AH R AH UH NG  G AH OH 
गरिदिनुभएकोमा		G AH R AH IH DH AH IH N AH UH BA AH EH K AH OH M AH AA 
गतेको		G AH TH AH EH K AH OH 
गत		G AH TH AH 
गणना		G AH N AH N AH AA 
खोजि		KA AH OH JH AH IH 
खेलकूद		KA AH EH L AH K AH UH DH AH 
खुसीसाथ		KA AH UH S AH IH S AH AA THA AH 
खिच्ने		KA AH IH CH  N AH EH 
खाजाको		KA AH AA JH AH AA K AH OH 
खरीद		KA AH R AH IH DH AH 
खतरा		KA AH TH AH R AH AA 
क्लेम		K  L AH EH M AH 
क्लबको		K  L AH B AH K AH OH 
क्रिपया		K  R AH IH P AH Y AH AA 
कोरिदिन		K AH OH R AH IH DH AH IH N AH 
केकको		K AH EH K AH K AH OH 
कुराएकोमा		K AH UH R AH AA EH K AH OH M AH AA 
किनें।		K AH IH N AH EH M
किताबमा		K AH IH TH AH AA B AH M AH AA 
कार्यक्रमहरु		K AH AA R  Y AH K  R AH M AH HH AH R AH UH 
कसैको		K AH S AH AH IH K AH OH 
कम्पनिलाई		K AH M  P AH N AH IH L AH AA IH 
कब्जीयत		K AH B  JH AH IH Y AH TH AH 
कनेक्सन		K AH N AH EH K  S AH N AH 
कतिमा		K AH TH AH IH M AH AA 
ओर्लनुपर्ने		OH R  L AH N AH UH P AH R  N AH EH 
एबीसी		EH B AH IH S AH IH 
एकपाँच		EH K AH P AH AAN CH AH 
उभिन		UH BA AH IH N AH 
उदाहरणको		UH DH AH AA HH AH R AH N AH K AH OH 
उत्साहित		UH TH  S AH AA HH AH IH TH AH 
उड्दै		UH D  DH AH AH IH 
उठाउनु		UH TA AH AA UH N AH UH 
आन्तरिक		AA N  TH AH R AH IH K AH 
आजै		AA JH AH AH IH 
आएपछि		AA EH P AH CHA AH IH 
आउनेछौं।		AA UH N AH EH CHA AH AH UH M
आउनुहुनेछ।		AA UH N AH UH HH AH UH N AH EH CHA AH 
आउनुभएकोले		AA UH N AH UH BA AH EH K AH OH L AH EH 
आउछु।		AA UH CHA AH UH 
आउँदो		AA UHN DH AH OH 
आउँछु		AA UHN CHA AH UH 
अविस्वसनीय।		AH W AH IH S  W AH S AH N AH IH Y AH 
अलिक		AH L AH IH K AH 
अबको		AH B AH K AH OH 
अपच		AH P AH CH AH 
अन्त्य		AH N  TH  Y AH 
अनुमती		AH N AH UH M AH TH AH IH 
अनुमतिपत्र		AH N AH UH M AH TH AH IH P AH TH  R AH 
अध्यारो		AH DHA  Y AH AA R AH OH 
अध्ययनको		AH DHA  Y AH Y AH N AH K AH OH 
अध्ययन		AH DHA  Y AH Y AH N AH 
अण्डा।		AH N  D AH AA 
अङ्ग्रेजीमा		AH NG  G  R AH EH JH AH IH M AH AA 
हेरौं		HH AH EH R AH AH UH M
हेर		HH AH EH R AH 
हुदैन		HH AH UH DH AH AH IH N AH 
हुँनुहुँन्छ।		HH AH UHN N AH UH HH AH UHN N  CHA AH 
हिजोदेखि।		HH AH IH JH AH OH DH AH EH KA AH IH 
हिऊँ		HH AH IH UHN 
हाल्नु		HH AH AA L  N AH UH 
हाई		HH AH AA IH 
हाँकिरहेको		HH AH AAN K AH IH R AH HH AH EH K AH OH 
हवाईमार्गबाट		HH AH W AH AA IH M AH AA R  G AH B AH AA T AH 
हवाइजहाजको		HH AH W AH AA IH JH AH HH AH AA JH AH K AH OH 
हल्लेको		HH AH L  L AH EH K AH OH 
स्यान्डविच्		S  Y AH AA N  D AH W AH IH CH  
स्यान		S  Y AH AA N AH 
स्त्रीको		S  TH  R AH IH K AH OH 
स्टाईल		S  T AH AA IH L AH 
स्कूबा		S  K AH UH B AH AA 
स्कि		S  K AH IH 
सोधपुछ		S AH OH DHA AH P AH UH CHA AH 
सोच्नेछु।		S AH OH CH  N AH EH CHA AH UH 
सुसी		S AH UH S AH IH 
सुनेकोले		S AH UH N AH EH K AH OH L AH EH 
सुनेकोछु।		S AH UH N AH EH K AH OH CHA AH UH 
सुखद		S AH UH KA AH DH AH 
सीमा		S AH IH M AH AA 
सिएटल		S AH IH EH T AH L AH 
सामानहरुलाई		S AH AA M AH AA N AH HH AH R AH UH L AH AA IH 
साटीदिनुहोस्।		S AH AA T AH IH DH AH IH N AH UH HH AH OH S  
साटिदिनुहोला।		S AH AA T AH IH DH AH IH N AH UH HH AH OH L AH AA 
सागसब्जीहरु		S AH AA G AH S AH B  JH AH IH HH AH R AH UH 
साके		S AH AA K AH EH 
साँस		S AH AAN S AH 
साँचो।		S AH AAN CH AH OH 
सलादमा		S AH L AH AA DH AH M AH AA 
सलादको		S AH L AH AA DH AH K AH OH 
सम्लगन		S AH M  L AH G AH N AH 
सभा		S AH BA AH AA 
सच्चै		S AH CH  CH AH AH IH 
सकीन।		S AH K AH IH N AH 
श्रीमतीलाई		S  R AH IH M AH TH AH IH L AH AA IH 
श्रिमती		S  R AH IH M AH TH AH IH 
शेयर		S AH EH Y AH R AH 
शुभकामना।		S AH UH BA AH K AH AA M AH N AH AA 
शटल		S AH T AH L AH 
शंका		S AH MK AH AA 
व्यापारको		W  Y AH AA P AH AA R AH K AH OH 
विद्यार्थीको		W AH IH DH  Y AH AA R  THA AH IH K AH OH 
वाणिज्य		W AH AA N AH IH JH  Y AH 
लोस		L AH OH S AH 
लेबल		L AH EH B AH L AH 
लेख्नुपर्छ		L AH EH KA  N AH UH P AH R  CHA AH 
लुटिएँ।		L AH UH T AH IH EHN 
लीन		L AH IH N AH 
लिएँ		L AH IH EHN 
लान्छु।		L AH AA N  CHA AH UH 
लन्डनको		L AH N  D AH N AH K AH OH 
लग्छ		L AH G  CHA AH 
लगी		L AH G AH IH 
रोलर		R AH OH L AH R AH 
रोकी		R AH OH K AH IH 
रूमहरु		R AH UH M AH HH AH R AH UH 
राष्ट्रीय		R AH AA S  T  R AH IH Y AH 
रात्रीभ्रमण		R AH AA TH  R AH IH BA  R AH M AH N AH 
राखीदिनुहोस्।		R AH AA KA AH IH DH AH IH N AH UH HH AH OH S  
राखीदिनुहुन्थ्यो		R AH AA KA AH IH DH AH IH N AH UH HH AH UH N  THA  Y AH OH 
रहनु		R AH HH AH N AH UH 
रहदानी		R AH HH AH DH AH AA N AH IH 
रस		R AH S AH 
रमाउनु		R AH M AH AA UH N AH UH 
रक्त		R AH K  TH AH 
योजस्तै		Y AH OH JH AH S  TH AH AH IH 
यूनाइटेड		Y AH UH N AH AA IH T AH EH D AH 
युनाईटेड		Y AH UH N AH AA IH T AH EH D AH 
यिनीहरुको		Y AH IH N AH IH HH AH R AH UH K AH OH 
यान		Y AH AA N AH 
यात्रा।		Y AH AA TH  R AH AA 
यातायात		Y AH AA TH AH AA Y AH AA TH AH 
यहा		Y AH HH AH AA 
यच		Y AH CH AH 
म्याट		M  Y AH AA T AH 
मुर्ख		M AH UH R  KA AH 
मालहरु		M AH AA L AH HH AH R AH UH 
मार्गदर्शक		M AH AA R  G AH DH AH R  S AH K AH 
मानिसको		M AH AA N AH IH S AH K AH OH 
माचिको		M AH AA CH AH IH K AH OH 
महिलाहरुको		M AH HH AH IH L AH AA HH AH R AH UH K AH OH 
महिना।		M AH HH AH IH N AH AA 
महानगरीय		M AH HH AH AA N AH G AH R AH IH Y AH 
मरीच		M AH R AH IH CH AH 
मनपर्यो		M AH N AH P AH R  Y AH OH 
मद्दतको		M AH DH  DH AH TH AH K AH OH 
भोल्टेज		BA AH OH L  T AH EH JH AH 
भैसक्यो		BA AH AH IH S AH K  Y AH OH 
भेतेरा		BA AH EH TH AH EH R AH AA 
भेट्नु		BA AH EH T  N AH UH 
भेट्टाएँ।		BA AH EH T  T AH AA EHN 
भेटघाटको		BA AH EH T AH GA AH AA T AH K AH OH 
भेगास		BA AH EH G AH AA S AH 
भुइमा		BA AH UH IH M AH AA 
भुइँमुनिको		BA AH UH IHN M AH UH N AH IH K AH OH 
भिन्नता		BA AH IH N  N AH TH AH AA 
भाइ		BA AH AA IH 
भरोसक्यो।		BA AH R AH OH S AH K  Y AH OH 
भरिसक्यो।		BA AH R AH IH S AH K  Y AH OH 
भरिभराउ		BA AH R AH IH BA AH R AH AA UH 
भय		BA AH Y AH 
भन्सारको		BA AH N  S AH AA R AH K AH OH 
भन्दै		BA AH N  DH AH AH IH 
भइसके।		BA AH IH S AH K AH EH 
ब्रोसर		B  R AH OH S AH R AH 
ब्रिज		B  R AH IH JH AH 
ब्रशुर		B  R AH S AH UH R AH 
ब्यूझाईदिनुहुन्छ		B  Y AH UH JHA AH AA IH DH AH IH N AH UH HH AH UH N  CHA AH 
बोलेको।		B AH OH L AH EH K AH OH 
बोर्डिंगको		B AH OH R  D AH IH MG AH K AH OH 
बेहोस्		B AH EH HH AH OH S  
बेलुकिको		B AH EH L AH UH K AH IH K AH OH 
बूटहरु		B AH UH T AH HH AH R AH UH 
बिहे		B AH IH HH AH EH 
बिल।		B AH IH L AH 
बिलकुल		B AH IH L AH K AH UH L AH 
बिमानस्थलको		B AH IH M AH AA N AH S  THA AH L AH K AH OH 
बिद्यार्थीहरुको		B AH IH DH  Y AH AA R  THA AH IH HH AH R AH UH K AH OH 
बिग्रीएको		B AH IH G  R AH IH EH K AH OH 
बातो		B AH AA TH AH OH 
बहत्तर		B AH HH AH TH  TH AH R AH 
बस्नुहोस्		B AH S  N AH UH HH AH OH S  
बस्छौं।		B AH S  CHA AH AH UH M
बसिरहेको		B AH S AH IH R AH HH AH EH K AH OH 
बसाइ		B AH S AH AA IH 
बन्दोबस्त		B AH N  DH AH OH B AH S  TH AH 
बत्तीबाट		B AH TH  TH AH IH B AH AA T AH 
बजारको		B AH JH AH AA R AH K AH OH 
फ्लास		PA  L AH AA S AH 
फ्लाईट कुन हो		PA  L AH AA IH T AH 
फ्रान्सको		PA  R AH AA N  S AH K AH OH 
फलफुलको		PA AH L AH PA AH UH L AH K AH OH 
फर्किनुपर्छ		PA AH R  K AH IH N AH UH P AH R  CHA AH 
फर्कनुहुनेछ		PA AH R  K AH N AH UH HH AH UH N AH EH CHA AH 
प्राचीन		P  R AH AA CH AH IH N AH 
प्रशिक्षक		P  R AH S AH IH K  S AH K AH 
प्रदान		P  R AH DH AH AA N AH 
प्रतिको		P  R AH TH AH IH K AH OH 
पोर्टर		P AH OH R  T AH R AH 
पोर्क		P AH OH R  K AH 
पोइन्ट		P AH OH IH N  T AH 
पुस्तिकाहरू		P AH UH S  TH AH IH K AH AA HH AH R AH UH 
पुष्टिकारन		P AH UH S  T AH IH K AH AA R AH N AH 
पुछ्न		P AH UH CHA  N AH 
पुछिदिन		P AH UH CHA AH IH DH AH IH N AH 
पुग्नेछौं।		P AH UH G  N AH EH CHA AH AH UH M
पुग्नुपर्छ		P AH UH G  N AH UH P AH R  CHA AH 
पिउँदिन।		P AH IH UHN DH AH IH N AH 
पाहुँना		P AH AA HH AH UHN N AH AA 
पासमा		P AH AA S AH M AH AA 
पार्सलको		P AH AA R  S AH L AH K AH OH 
पाठ		P AH AA TA AH 
पाखुरामा		P AH AA KA AH UH R AH AA M AH AA 
पाँचसय		P AH AAN CH AH S AH Y AH 
परिबर्तन		P AH R AH IH B AH R  TH AH N AH 
पथप्रदर्शक		P AH THA AH P  R AH DH AH R  S AH K AH 
पठाइदिनुहोला।		P AH TA AH AA IH DH AH IH N AH UH HH AH OH L AH AA 
पछिल्लो		P AH CHA AH IH L  L AH OH 
निर्देशक		N AH IH R  DH AH EH S AH K AH 
निजी		N AH IH JH AH IH 
नापिदिन्छु।		N AH AA P AH IH DH AH IH N  CHA AH UH 
नाच		N AH AA CH AH 
नाइट		N AH AA IH T AH 
नाँच्न		N AH AAN CH  N AH 
नराम्रो।		N AH R AH AA M  R AH OH 
नराम्रोसँग		N AH R AH AA M  R AH OH S AHN G AH 
नमान्नुहोस्।		N AH M AH AA N  N AH UH HH AH OH S  
नगर।		N AH G AH R AH 
नगरी		N AH G AH R AH IH 
धुलाएर		DHA AH UH L AH AA EH R AH 
दौडिन्छ		DH AH AH UH D AH IH N  CHA AH 
दे।		DH AH EH 
देखें।		DH AH EH KA AH EH M
देखिनेकोठा		DH AH EH KA AH IH N AH EH K AH OH TA AH AA 
देखाउनुहोस्		DH AH EH KA AH AA UH N AH UH HH AH OH S  
दुईबोतल		DH AH UH IH B AH OH TH AH L AH 
दिनुस्।		DH AH IH N AH UH S  
दिनका		DH AH IH N AH K AH AA 
दायाँबाट		DH AH AA Y AH AAN B AH AA T AH 
दाजुभाइ		DH AH AA JH AH UH BA AH AA IH 
दशका		DH AH S AH K AH AA 
थोरै।		THA AH OH R AH AH IH 
थालेको		THA AH AA L AH EH K AH OH 
तेज		TH AH EH JH AH 
तिनिहरु		TH AH IH N AH IH HH AH R AH UH 
तास		TH AH AA S AH 
तारिक		TH AH AA R AH IH K AH 
तार		TH AH AA R AH 
तहको		TH AH HH AH K AH OH 
तरिकामा		TH AH R AH IH K AH AA M AH AA 
तपाईंबाट		TH AH P AH AA IH MB AH AA T AH 
डोरी		D AH OH R AH IH 
डाउनटाउनको		D AH AA UH N AH T AH AA UH N AH K AH OH 
ठाउ		TA AH AA UH 
ट्याबलेट		T  Y AH AA B AH L AH EH T AH 
टोइलेट		T AH OH IH L AH EH T AH 
टेलिफोनको		T AH EH L AH IH PA AH OH N AH K AH OH 
टिकटहरू।		T AH IH K AH T AH HH AH R AH UH 
टाईम्स		T AH AA IH M  S AH 
टाइम		T AH AA IH M AH 
टन्सिल		T AH N  S AH IH L AH 
झिक्ने		JHA AH IH K  N AH EH 
झार्न		JHA AH AA R  N AH 
झर्यो।		JHA AH R  Y AH OH 
जोड		JH AH OH D AH 
जानै		JH AH AA N AH AH IH 
जाँदैछौ		JH AH AAN DH AH AH IH CHA AH AH UH 
जाँड		JH AH AAN D AH 
जरुरि		JH AH R AH UH R AH IH 
जबसम्म		JH AH B AH S AH M  M AH 
छोडीदिनुहोस्।		CHA AH OH D AH IH DH AH IH N AH UH HH AH OH S  
छुट्टिएँ।		CHA AH UH T  T AH IH EHN 
छुटको		CHA AH UH T AH K AH OH 
छिन।		CHA AH IH N AH 
चिकन		CH AH IH K AH N AH 
चारको		CH AH AA R AH K AH OH 
चाप		CH AH AA P AH 
चलाउनु		CH AH L AH AA UH N AH UH 
चलाउँछु।		CH AH L AH AA UHN CHA AH UH 
चक्लेट		CH AH K  L AH EH T AH 
घोषणामा		GA AH OH S AH N AH AA M AH AA 
घाममा		GA AH AA M AH M AH AA 
घरमा।		GA AH R AH M AH AA 
घंटा		GA AH MT AH AA 
गोल्डेन		G AH OH L  D AH EH N AH 
गोडामा		G AH OH D AH AA M AH AA 
गैरहेको		G AH AH IH R AH HH AH EH K AH OH 
गुणस्तर		G AH UH N AH S  TH AH R AH 
गिफ्ट		G AH IH PA  T AH 
गर्नैपर्छ।		G AH R  N AH AH IH P AH R  CHA AH 
गर्नेछौं		G AH R  N AH EH CHA AH AH UH M
गर्नेछौँ।		G AH R  N AH EH CHA AH AH UHN 
गर्दैहुनुहुन्छ।		G AH R  DH AH AH IH HH AH UH N AH UH HH AH UH N  CHA AH 
गर्दैछ		G AH R  DH AH AH IH CHA AH 
गर्दिन		G AH R  DH AH IH N AH 
गरेकोले		G AH R AH EH K AH OH L AH EH 
गरुं		G AH R AH UH M
गरिसकेका		G AH R AH IH S AH K AH EH K AH AA 
गर		G AH R AH 
गन्ध		G AH N  DHA AH 
खोज्ने		KA AH OH JH  N AH EH 
खेरि		KA AH EH R AH IH 
खुल्लै		KA AH UH L  L AH AH IH 
खुलै		KA AH UH L AH AH IH 
खुलेन।		KA AH UH L AH EH N AH 
खुलेको		KA AH UH L AH EH K AH OH 
खुलाउने		KA AH UH L AH AA UH N AH EH 
खुब		KA AH UH B AH 
खुट्टामा		KA AH UH T  T AH AA M AH AA 
खामहरु		KA AH AA M AH HH AH R AH UH 
खानेकुराहरु		KA AH AA N AH EH K AH UH R AH AA HH AH R AH UH 
खाजाहरू		KA AH AA JH AH AA HH AH R AH UH 
खाऔं।		KA AH AA AH UN M
खाँदा		KA AH AAN DH AH AA 
खतरनाक		KA AH TH AH R AH N AH AA K AH 
क्यास		K  Y AH AA S AH 
क्याशर		K  Y AH AA S AH R AH 
क्यालोरी		K  Y AH AA L AH OH R AH IH 
कोरि		K AH OH R AH IH 
कोडाक		K AH OH D AH AA K AH 
कोच		K AH OH CH AH 
कृपया तातो चिया दिनुहोस्।		K AH R P AH Y AH AA DH AH IH N AH UH HH AH OH S  
कुक		K AH UH K AH 
किनेर		K AH IH N AH EH R AH 
किनारमा		K AH IH N AH AA R AH M AH AA 
किताबको		K AH IH TH AH AA B AH K AH OH 
कारखाना		K AH AA R AH KA AH AA N AH AA 
कानमा		K AH AA N AH M AH AA 
काठको		K AH AA TA AH K AH OH 
काटें।		K AH AA T AH EH M
काटेँ।		K AH AA T AH EHN 
काँचै		K AH AAN CH AH AH IH 
कहिलेको		K AH HH AH IH L AH EH K AH OH 
कमीज		K AH M AH IH JH AH 
कतिजति		K AH TH AH IH JH AH TH AH IH 
औजारहरु		AH UN JH AH AA R AH HH AH R AH UH 
ओरेन्ज		OH R AH EH N  JH AH 
ओभरसिज		OH BA AH R AH S AH IH JH AH 
एरिया		EH R AH IH Y AH AA 
एबिसी		EH B AH IH S AH IH 
एन्जलस		EH N  JH AH L AH S AH 
एण्ड		EH N  D AH 
एक्सपोजर		EH K  S AH P AH OH JH AH R AH 
एकदम्मै		EH K AH DH AH M  M AH AH IH 
उसो		UH S AH OH 
उनिहरु		UH N AH IH HH AH R AH UH 
उत्तेजित		UH TH  TH AH EH JH AH IH TH AH 
उत्तरी		UH TH  TH AH R AH IH 
इतो		IH TH AH OH 
इटालीयन		IH T AH AA L AH IH Y AH N AH 
आफैसंग		AA PA AH AH IH S AH MG AH 
आपतकालीन		AA P AH TH AH K AH AA L AH IH N AH 
आठ।		AA TA AH 
आठबजे		AA TA AH B AH JH AH EH 
आउनुहुनेछ		AA UH N AH UH HH AH UH N AH EH CHA AH 
आउँछन्		AA UHN CHA AH N  
आई।		AA IH 
आईसक्रिम		AA IH S AH K  R AH IH M AH 
आइरहन्छ।		AA IH R AH HH AH N  CHA AH 
आइपुगें।		AA IH P AH UH G AH EH M
अस्पतालामा		AH S  P AH TH AH AA L AH AA M AH AA 
असल		AH S AH L AH 
अवस्थित		AH W AH S  THA AH IH TH AH 
अर्थशास्त्र		AH R  THA AH S AH AA S  TH  R AH 
अफ्नो		AH PA  N AH OH 
अपरेटर।		AH P AH R AH EH T AH R AH 
अन्त्यमा		AH N  TH  Y AH M AH AA 
अन्तरराष्ट्रिय		AH N  TH AH R AH R AH AA S  T  R AH IH Y AH 
अण्डाहरु		AH N  D AH AA HH AH R AH UH 
अड्डामा		AH D  D AH AA M AH AA 
अचम्म		AH CH AH M  M AH 
अगाडीनै		AH G AH AA D AH IH N AH AH IH 
अँग्रेज		AHN G  R AH EH JH AH 
अ		AH 
